,COUNTY,VAP,NAME,WVAP,SEN18D,SEN18R,OVAP,TOT_VOTES,factor,WVAP_pct,OVAP_pct,SEN18None,SEN18D_pct,SEN18R_pct,SEN18None_pct
388,Prince George's,1692,Prince George's Precinct 08-001,980,247,151,712,1692,1,0.5791962174940898,0.42080378250591016,1294,0.14598108747044916,0.08924349881796691,0.764775413711584
389,Prince George's,2531,Prince George's Precinct 11-002,511,939,105,2020,2531,1,0.20189648360331885,0.7981035163966812,1487,0.3709996048992493,0.04148557882259976,0.5875148162781509
390,Prince George's,3507,Prince George's Precinct 15-001,574,1314,106,2933,3507,1,0.16367265469061876,0.8363273453093812,2087,0.3746792130025663,0.03022526375819789,0.5950955232392359
391,Prince George's,3267,Prince George's Precinct 15-004,469,1096,95,2798,3267,1,0.1435567799204163,0.8564432200795837,2076,0.3354759718396082,0.029078665442301806,0.63544536271809
392,Prince George's,2065,Prince George's Precinct 04-001,1341,402,272,724,2065,1,0.6493946731234866,0.3506053268765133,1391,0.1946731234866828,0.13171912832929783,0.6736077481840194
394,Prince George's,1133,Prince George's Precinct 03-001,419,321,85,714,1133,1,0.3698146513680494,0.6301853486319505,727,0.2833186231244484,0.07502206531332745,0.6416593115622242
400,Prince George's,1983,Prince George's Precinct 12-002,167,529,33,1816,1983,1,0.08421583459404942,0.9157841654059505,1421,0.26676752395360565,0.01664145234493192,0.7165910237014624
401,Prince George's,4528,Prince George's Precinct 12-009,53,750,19,4475,4528,1,0.011704946996466431,0.9882950530035336,3759,0.16563604240282687,0.004196113074204947,0.8301678445229682
402,Prince George's,4488,Prince George's Precinct 12-004,126,970,26,4362,4488,1,0.02807486631016043,0.9719251336898396,3492,0.2161319073083779,0.005793226381461676,0.7780748663101604
403,Prince George's,4072,Prince George's Precinct 12-006,80,900,27,3992,4072,1,0.019646365422396856,0.9803536345776032,3145,0.22102161100196463,0.006630648330058939,0.7723477406679764
404,Prince George's,3288,Prince George's Precinct 12-012,212,752,30,3076,3288,1,0.06447688564476886,0.9355231143552312,2506,0.22871046228710462,0.009124087591240875,0.7621654501216545
405,Prince George's,2724,Prince George's Precinct 12-016,113,596,19,2611,2724,1,0.041483113069016156,0.9585168869309838,2109,0.21879588839941264,0.0069750367107195305,0.7742290748898678
406,Prince George's,3144,Prince George's Precinct 12-003,178,802,27,2966,3144,1,0.056615776081424936,0.943384223918575,2315,0.255089058524173,0.008587786259541985,0.736323155216285
407,Prince George's,1980,Prince George's Precinct 12-007,69,708,39,1911,1980,1,0.03484848484848485,0.9651515151515152,1233,0.3575757575757576,0.019696969696969695,0.6227272727272727
408,Prince George's,1110,Prince George's Precinct 12-017,127,182,2,983,1110,1,0.11441441441441441,0.8855855855855855,926,0.16396396396396395,0.0018018018018018018,0.8342342342342343
409,Prince George's,3753,Prince George's Precinct 12-013,94,983,28,3659,3753,1,0.025046629363176125,0.9749533706368239,2742,0.26192379429789503,0.007460698108180123,0.7306155075939249
410,Prince George's,2131,Prince George's Precinct 06-008,57,633,20,2074,2131,1,0.02674800563115908,0.9732519943688409,1478,0.2970436414828719,0.009385265133740028,0.6935710933833881
411,Prince George's,4750,Prince George's Precinct 06-017,139,1038,22,4611,4750,1,0.02926315789473684,0.9707368421052631,3690,0.21852631578947368,0.0046315789473684215,0.7768421052631579
412,Prince George's,2691,Prince George's Precinct 06-009,88,699,19,2603,2691,1,0.032701597918989224,0.9672984020810108,1973,0.25975473801560756,0.007060572277963582,0.7331846897064288
413,Prince George's,2205,Prince George's Precinct 06-012,55,659,15,2150,2205,1,0.024943310657596373,0.9750566893424036,1531,0.29886621315192746,0.006802721088435374,0.6943310657596372
452,Prince George's,2194,Prince George's Precinct 12-008,175,568,18,2019,2194,1,0.07976298997265269,0.9202370100273473,1608,0.25888787602552416,0.008204193254329991,0.7329079307201458
453,Prince George's,2657,Prince George's Precinct 12-015,108,787,34,2549,2657,1,0.04064734663153933,0.9593526533684607,1836,0.29619872036130973,0.01279638690252164,0.6910048927361686
470,Prince George's,3323,Prince George's Precinct 09-007,221,1255,58,3102,3323,1,0.06650616912428528,0.9334938308757147,2010,0.3776707794161902,0.017454107733975325,0.6048751128498345
471,Prince George's,2034,Prince George's Precinct 09-004,273,750,39,1761,2034,1,0.13421828908554573,0.8657817109144543,1245,0.3687315634218289,0.019174041297935103,0.612094395280236
472,Prince George's,3032,Prince George's Precinct 09-005,266,900,42,2766,3032,1,0.08773087071240106,0.912269129287599,2090,0.29683377308707126,0.013852242744063324,0.6893139841688655
473,Prince George's,3691,Prince George's Precinct 09-001,425,1229,70,3266,3691,1,0.11514494716878895,0.884855052831211,2392,0.33297209428339203,0.01896505012191818,0.6480628555946898
474,Prince George's,2377,Prince George's Precinct 09-010,356,775,49,2021,2377,1,0.14976861590239798,0.850231384097602,1553,0.3260412284392091,0.020614219604543543,0.6533445519562474
475,Prince George's,3501,Prince George's Precinct 09-002,398,1195,80,3103,3501,1,0.11368180519851472,0.8863181948014853,2226,0.3413310482719223,0.022850614110254214,0.6358183376178235
476,Prince George's,4703,Prince George's Precinct 09-008,452,1603,77,4251,4703,1,0.09610886668084201,0.9038911333191579,3023,0.3408462683393579,0.016372528173506273,0.6427812034871359
477,Prince George's,2747,Prince George's Precinct 09-006,357,1223,46,2390,2747,1,0.12995995631598106,0.8700400436840189,1478,0.44521295959228246,0.016745540589734254,0.5380414998179832
478,Prince George's,2862,Prince George's Precinct 11-004,854,1435,149,2008,2862,1,0.2983927323549965,0.7016072676450035,1278,0.5013976240391335,0.052061495457721874,0.44654088050314467
479,Prince George's,2840,Prince George's Precinct 11-001,589,909,104,2251,2840,1,0.2073943661971831,0.7926056338028169,1827,0.3200704225352113,0.036619718309859155,0.6433098591549296
480,Prince George's,4018,Prince George's Precinct 09-011,519,1059,99,3499,4018,1,0.12916874066699852,0.8708312593330015,2860,0.2635639621702339,0.02463912394225983,0.7117969138875062
481,Prince George's,1565,Prince George's Precinct 09-009,577,448,61,988,1565,1,0.36869009584664536,0.6313099041533546,1056,0.28626198083067095,0.038977635782747606,0.6747603833865815
482,Prince George's,3439,Prince George's Precinct 11-003,484,1339,89,2955,3439,1,0.14073858679848794,0.8592614132015121,2011,0.38935737132887466,0.02587961616749055,0.5847630125036348
483,Prince George's,2108,Prince George's Precinct 15-003,209,747,40,1899,2108,1,0.099146110056926,0.900853889943074,1321,0.3543643263757116,0.018975332068311195,0.6266603415559773
484,Prince George's,662,Prince George's Precinct 01-007,394,524,126,268,662,1,0.595166163141994,0.40483383685800606,12,0.7915407854984894,0.1903323262839879,0.01812688821752266
485,Prince George's,2108,Prince George's Precinct 06-014,231,616,32,1877,2108,1,0.10958254269449716,0.8904174573055028,1460,0.2922201138519924,0.015180265654648957,0.6925996204933587
486,Prince George's,1176,Prince George's Precinct 06-002,134,443,23,1042,1176,1,0.11394557823129252,0.8860544217687075,710,0.37670068027210885,0.0195578231292517,0.6037414965986394
487,Prince George's,2560,Prince George's Precinct 06-013,365,821,50,2195,2560,1,0.142578125,0.857421875,1689,0.320703125,0.01953125,0.659765625
488,Prince George's,3164,Prince George's Precinct 06-024,123,740,21,3041,3164,1,0.0388748419721871,0.9611251580278128,2403,0.23388116308470291,0.00663716814159292,0.7594816687737042
489,Prince George's,3700,Prince George's Precinct 06-015,61,938,13,3639,3700,1,0.016486486486486488,0.9835135135135135,2749,0.25351351351351353,0.0035135135135135136,0.7429729729729729
490,Prince George's,576,Prince George's Precinct 06-021,41,169,7,535,576,1,0.07118055555555555,0.9288194444444444,400,0.2934027777777778,0.012152777777777778,0.6944444444444444
491,Prince George's,4119,Prince George's Precinct 06-004,104,821,26,4015,4119,1,0.02524884680747754,0.9747511531925225,3272,0.1993202233551833,0.006312211701869385,0.7943675649429474
492,Prince George's,4084,Prince George's Precinct 06-022,93,1016,34,3991,4084,1,0.02277179236043095,0.9772282076395691,3034,0.24877571008814886,0.00832517140058766,0.7428991185112634
493,Prince George's,3744,Prince George's Precinct 06-006,97,788,21,3647,3744,1,0.02590811965811966,0.9740918803418803,2935,0.21047008547008547,0.005608974358974359,0.7839209401709402
494,Prince George's,2295,Prince George's Precinct 06-018,268,683,38,2027,2295,1,0.11677559912854031,0.8832244008714597,1574,0.29760348583877994,0.016557734204793027,0.6858387799564271
495,Prince George's,4108,Prince George's Precinct 06-007,492,1357,70,3616,4108,1,0.11976630963972736,0.8802336903602727,2681,0.3303310613437196,0.017039922103213243,0.6526290165530672
496,Prince George's,1925,Prince George's Precinct 09-003,1159,92,35,766,1925,1,0.6020779220779221,0.3979220779220779,1798,0.047792207792207796,0.01818181818181818,0.934025974025974
497,Prince George's,3624,Prince George's Precinct 06-016,134,807,21,3490,3624,1,0.0369757174392936,0.9630242825607064,2796,0.222682119205298,0.005794701986754967,0.7715231788079471
498,Prince George's,1985,Prince George's Precinct 06-005,102,628,22,1883,1985,1,0.05138539042821159,0.9486146095717884,1335,0.3163727959697733,0.011083123425692695,0.672544080604534
499,Prince George's,3207,Prince George's Precinct 06-010,129,765,22,3078,3207,1,0.040224508886810104,0.9597754911131899,2420,0.23854069223573432,0.006859993763642033,0.7545993140006236
500,Prince George's,2204,Prince George's Precinct 06-011,132,872,23,2072,2204,1,0.05989110707803993,0.9401088929219601,1309,0.3956442831215971,0.010435571687840291,0.5939201451905626
501,Prince George's,3824,Prince George's Precinct 06-001,272,1076,26,3552,3824,1,0.07112970711297072,0.9288702928870293,2722,0.2813807531380753,0.006799163179916318,0.7118200836820083
502,Prince George's,4367,Prince George's Precinct 06-003,124,1152,30,4243,4367,1,0.028394779024501948,0.9716052209754981,3185,0.26379665674376,0.0068697046027020835,0.729333638653538
503,Prince George's,2231,Prince George's Precinct 18-011,68,574,15,2163,2231,1,0.03047960555804572,0.9695203944419543,1642,0.2572837292693859,0.006723442402510085,0.735992828328104
504,Prince George's,2252,Prince George's Precinct 18-004,81,519,10,2171,2252,1,0.03596802841918295,0.9640319715808171,1723,0.23046181172291297,0.004440497335701598,0.7650976909413855
505,Prince George's,3235,Prince George's Precinct 18-001,86,1023,12,3149,3235,1,0.026584234930448224,0.9734157650695517,2200,0.31622874806800616,0.0037094281298299847,0.6800618238021638
506,Prince George's,1927,Prince George's Precinct 02-007,906,694,166,1021,1927,1,0.4701608718214842,0.5298391281785159,1067,0.3601453035806954,0.08614426569797613,0.5537104307213285
507,Prince George's,1859,Prince George's Precinct 18-005,22,489,15,1837,1859,1,0.011834319526627219,0.9881656804733728,1355,0.26304464766003227,0.008068854222700376,0.7288864981172674
508,Prince George's,2460,Prince George's Precinct 18-003,23,707,5,2437,2460,1,0.00934959349593496,0.990650406504065,1748,0.28739837398373985,0.0020325203252032522,0.7105691056910569
509,Prince George's,158,Prince George's Precinct 18-012,5,23,3,153,158,1,0.03164556962025317,0.9683544303797469,132,0.14556962025316456,0.0189873417721519,0.8354430379746836
510,Prince George's,3010,Prince George's Precinct 02-003,624,850,116,2386,3010,1,0.20730897009966778,0.7926910299003322,2044,0.2823920265780731,0.038538205980066444,0.6790697674418604
511,Prince George's,1792,Prince George's Precinct 18-009,52,732,17,1740,1792,1,0.029017857142857144,0.9709821428571429,1043,0.40848214285714285,0.009486607142857142,0.58203125
512,Prince George's,2682,Prince George's Precinct 06-019,56,703,19,2626,2682,1,0.020879940343027592,0.9791200596569725,1960,0.2621178225205071,0.0070842654735272185,0.7307979120059657
513,Prince George's,2589,Prince George's Precinct 18-007,40,871,17,2549,2589,1,0.01544998068752414,0.9845500193124759,1701,0.33642332947083814,0.00656624179219776,0.657010428736964
514,Prince George's,1021,Prince George's Precinct 18-010,7,284,3,1014,1021,1,0.0068560235063663075,0.9931439764936337,734,0.2781586679725759,0.002938295788442703,0.7189030362389814
515,Prince George's,3626,Prince George's Precinct 18-006,28,1027,20,3598,3626,1,0.007722007722007722,0.9922779922779923,2579,0.2832322118036404,0.005515719801434087,0.7112520683949255
516,Prince George's,2067,Prince George's Precinct 18-002,31,532,11,2036,2067,1,0.014997581035316884,0.9850024189646831,1524,0.25737784228350263,0.005321722302854378,0.737300435413643
517,Prince George's,1716,Prince George's Precinct 18-008,12,510,11,1704,1716,1,0.006993006993006993,0.993006993006993,1195,0.2972027972027972,0.00641025641025641,0.6963869463869464
518,Prince George's,2019,Prince George's Precinct 13-017,34,600,18,1985,2019,1,0.016840019811788013,0.9831599801882119,1401,0.2971768202080238,0.008915304606240713,0.6939078751857355
519,Prince George's,3377,Prince George's Precinct 13-002,56,654,15,3321,3377,1,0.01658276576843352,0.9834172342315665,2708,0.19366301450992005,0.004441812259401836,0.8018951732306782
520,Prince George's,3376,Prince George's Precinct 13-016,73,1034,13,3303,3376,1,0.021623222748815167,0.9783767772511849,2329,0.3062796208530806,0.0038507109004739335,0.6898696682464455
521,Prince George's,1837,Prince George's Precinct 06-023,120,553,22,1717,1837,1,0.065323897659227,0.934676102340773,1262,0.3010342950462711,0.011976047904191617,0.6869896570495373
522,Prince George's,2581,Prince George's Precinct 15-006,524,923,73,2057,2581,1,0.2030220844633863,0.7969779155366137,1585,0.357613328167377,0.02828361100348702,0.614103060829136
523,Prince George's,1908,Prince George's Precinct 15-002,268,968,44,1640,1908,1,0.14046121593291405,0.859538784067086,896,0.5073375262054507,0.023060796645702306,0.469601677148847
524,Prince George's,3547,Prince George's Precinct 06-020,113,1134,29,3434,3547,1,0.0318579080913448,0.9681420919086552,2384,0.3197067944742035,0.00817592331547787,0.6721172822103186
525,Prince George's,3847,Prince George's Precinct 13-009,155,962,20,3692,3847,1,0.04029113595009098,0.9597088640499091,2865,0.2500649857031453,0.005198856251624643,0.7447361580452301
526,Prince George's,3713,Prince George's Precinct 13-007,71,1495,35,3642,3713,1,0.019122003770535956,0.980877996229464,2183,0.4026393751683275,0.009426339886883921,0.5879342849447886
527,Prince George's,2328,Prince George's Precinct 13-001,22,554,12,2306,2328,1,0.009450171821305841,0.9905498281786942,1762,0.23797250859106528,0.005154639175257732,0.756872852233677
528,Prince George's,3108,Prince George's Precinct 13-008,39,603,22,3069,3108,1,0.012548262548262547,0.9874517374517374,2483,0.19401544401544402,0.007078507078507079,0.7989060489060489
529,Prince George's,2837,Prince George's Precinct 13-014,46,1389,38,2791,2837,1,0.016214310891787098,0.9837856891082128,1410,0.48960169192809305,0.013394430736693691,0.49700387733521323
530,Prince George's,2601,Prince George's Precinct 13-006,72,946,30,2529,2601,1,0.02768166089965398,0.972318339100346,1625,0.36370626682045365,0.011534025374855825,0.6247597078046905
531,Prince George's,2331,Prince George's Precinct 13-004,111,784,24,2220,2331,1,0.047619047619047616,0.9523809523809523,1523,0.33633633633633636,0.010296010296010296,0.6533676533676533
532,Prince George's,3707,Prince George's Precinct 13-010,139,1509,37,3568,3707,1,0.03749662800107904,0.962503371998921,2161,0.4070677097383329,0.009981116806042621,0.5829511734556245
533,Prince George's,2929,Prince George's Precinct 13-012,55,1118,29,2874,2929,1,0.018777739842949812,0.9812222601570502,1782,0.3817002389894162,0.009900990099009901,0.6083987709115739
534,Prince George's,3609,Prince George's Precinct 13-011,78,1379,36,3531,3609,1,0.021612635078969242,0.9783873649210307,2194,0.3821003047935716,0.00997506234413965,0.6079246328622887
535,Prince George's,2772,Prince George's Precinct 02-001,146,468,23,2626,2772,1,0.05266955266955267,0.9473304473304474,2281,0.16883116883116883,0.008297258297258298,0.8228715728715729
538,Prince George's,5983,Prince George's Precinct 02-008,376,1097,63,5607,5983,1,0.06284472672572289,0.9371552732742772,4823,0.18335283302690958,0.010529834531171654,0.8061173324419187
539,Prince George's,1018,Prince George's Precinct 16-001,194,240,29,824,1018,1,0.1905697445972495,0.8094302554027505,749,0.2357563850687623,0.02848722986247544,0.7357563850687623
540,Prince George's,21,Prince George's Precinct 02-098,3,0,0,18,21,1,0.14285714285714285,0.8571428571428571,21,0.0,0.0,1.0
541,Prince George's,2869,Prince George's Precinct 02-005,244,414,44,2625,2869,1,0.08504705472289996,0.9149529452771,2411,0.1443011502265598,0.01533635413035901,0.8403624956430812
542,Prince George's,28,Prince George's Precinct 19-005,8,2,0,20,28,1,0.2857142857142857,0.7142857142857143,26,0.07142857142857142,0.0,0.9285714285714286
543,Prince George's,3247,Prince George's Precinct 19-004,243,427,33,3004,3247,1,0.0748383122882661,0.9251616877117339,2787,0.1315060055435787,0.010163227594702803,0.8583307668617185
544,Prince George's,4769,Prince George's Precinct 19-001,1023,831,135,3746,4769,1,0.21451037953449362,0.7854896204655064,3803,0.17425036695323967,0.02830782134619417,0.7974418117005662
545,Prince George's,5173,Prince George's Precinct 21-002,4074,428,101,1099,5173,1,0.7875507442489851,0.2124492557510149,4644,0.08273728977382563,0.019524453895225207,0.8977382563309492
546,Prince George's,3965,Prince George's Precinct 21-001,2283,627,128,1682,3965,1,0.5757881462799496,0.42421185372005044,3210,0.15813366960907946,0.03228247162673392,0.8095838587641866
547,Prince George's,4029,Prince George's Precinct 19-002,566,594,76,3463,4029,1,0.14048150905931994,0.8595184909406801,3359,0.14743112434847358,0.018863241499131298,0.8337056341523952
642,Prince George's,2195,Prince George's Precinct 14-003,1525,506,281,670,2195,1,0.6947608200455581,0.3052391799544419,1408,0.2305239179954442,0.12801822323462414,0.6414578587699317
643,Prince George's,3107,Prince George's Precinct 14-009,934,1012,180,2173,3107,1,0.30061152236884453,0.6993884776311554,1915,0.3257161248793048,0.057933698101062116,0.6163501770196331
644,Prince George's,3658,Prince George's Precinct 14-011,1034,944,232,2624,3658,1,0.2826681246582832,0.7173318753417168,2482,0.25806451612903225,0.0634226353198469,0.6785128485511208
645,Prince George's,2812,Prince George's Precinct 14-005,1565,714,256,1247,2812,1,0.5565433854907539,0.44345661450924606,1842,0.25391180654338547,0.09103840682788052,0.655049786628734
646,Prince George's,1482,Prince George's Precinct 07-017,301,426,47,1181,1482,1,0.20310391363022942,0.7968960863697706,1009,0.2874493927125506,0.03171390013495277,0.6808367071524967
647,Prince George's,2094,Prince George's Precinct 07-003,1459,508,285,635,2094,1,0.6967526265520535,0.3032473734479465,1301,0.24259789875835722,0.1361031518624642,0.6212989493791786
648,Prince George's,3594,Prince George's Precinct 07-010,650,1102,123,2944,3594,1,0.1808569838619922,0.8191430161380078,2369,0.30662214802448523,0.034223706176961605,0.6591541457985531
649,Prince George's,1540,Prince George's Precinct 07-002,1095,394,216,445,1540,1,0.711038961038961,0.288961038961039,930,0.2558441558441558,0.14025974025974025,0.6038961038961039
650,Prince George's,2018,Prince George's Precinct 14-004,1357,513,268,661,2018,1,0.6724479682854311,0.32755203171456887,1237,0.25421209117938554,0.13280475718533202,0.6129831516352825
651,Prince George's,2095,Prince George's Precinct 07-004,1404,515,325,691,2095,1,0.6701670644391408,0.3298329355608592,1255,0.2458233890214797,0.15513126491646778,0.5990453460620525
652,Prince George's,1545,Prince George's Precinct 14-006,1146,330,225,399,1545,1,0.7417475728155339,0.258252427184466,990,0.21359223300970873,0.14563106796116504,0.6407766990291263
653,Prince George's,2933,Prince George's Precinct 07-007,962,876,130,1971,2933,1,0.32799181725196047,0.6720081827480395,1927,0.29867030344357315,0.04432321854756222,0.6570064780088647
719,Prince George's,2532,Prince George's Precinct 05-012,333,966,67,2199,2532,1,0.13151658767772512,0.8684834123222749,1499,0.3815165876777251,0.02646129541864139,0.5920221169036335
729,Prince George's,2131,Prince George's Precinct 05-008,1047,446,139,1084,2131,1,0.4913186297512905,0.5086813702487095,1546,0.20929141248240263,0.0652275926794932,0.7254809948381041
730,Prince George's,3225,Prince George's Precinct 05-007,467,1079,112,2758,3225,1,0.1448062015503876,0.8551937984496124,2034,0.3345736434108527,0.03472868217054263,0.6306976744186047
731,Prince George's,1984,Prince George's Precinct 05-002,266,594,72,1718,1984,1,0.13407258064516128,0.8659274193548387,1318,0.29939516129032256,0.036290322580645164,0.6643145161290323
732,Prince George's,2501,Prince George's Precinct 12-014,295,834,100,2206,2501,1,0.11795281887245102,0.882047181127549,1567,0.33346661335465816,0.03998400639744103,0.6265493802479009
733,Prince George's,3254,Prince George's Precinct 12-010,477,1158,126,2777,3254,1,0.14658881376767055,0.8534111862323295,1970,0.35586969883220654,0.03872157344806392,0.6054087277197295
734,Prince George's,3255,Prince George's Precinct 05-005,506,1198,93,2749,3255,1,0.1554531490015361,0.8445468509984639,1964,0.36804915514592934,0.02857142857142857,0.6033794162826421
735,Prince George's,1334,Prince George's Precinct 05-010,244,373,51,1090,1334,1,0.18290854572713644,0.8170914542728636,910,0.27961019490254874,0.03823088455772114,0.6821589205397302
736,Prince George's,522,Prince George's Precinct 05-009,88,170,20,434,522,1,0.1685823754789272,0.8314176245210728,332,0.32567049808429116,0.038314176245210725,0.6360153256704981
737,Prince George's,3343,Prince George's Precinct 05-001,752,1460,130,2591,3343,1,0.2249476518097517,0.7750523481902483,1753,0.43673347292850734,0.03888722704157942,0.5243793000299133
738,Prince George's,2929,Prince George's Precinct 05-004,274,880,50,2655,2929,1,0.09354728576305907,0.906452714236941,1999,0.300443837487197,0.01707067258449983,0.6824854899283032
739,Prince George's,2112,Prince George's Precinct 05-011,181,723,45,1931,2112,1,0.08570075757575757,0.9142992424242424,1344,0.34232954545454547,0.02130681818181818,0.6363636363636364
740,Prince George's,2992,Prince George's Precinct 05-006,233,888,70,2759,2992,1,0.07787433155080214,0.9221256684491979,2034,0.2967914438502674,0.02339572192513369,0.6798128342245989
741,Prince George's,3474,Prince George's Precinct 12-005,353,872,79,3121,3474,1,0.10161197466896948,0.8983880253310305,2523,0.2510074841681059,0.02274035693724813,0.7262521588946459
742,Prince George's,2412,Prince George's Precinct 12-001,299,439,52,2113,2412,1,0.12396351575456054,0.8760364842454395,1921,0.18200663349917082,0.02155887230514096,0.7964344941956882
743,Prince George's,4027,Prince George's Precinct 12-011,258,1062,66,3769,4027,1,0.06406754407747703,0.9359324559225229,2899,0.2637198907375217,0.016389371740749937,0.7198907375217284
744,Prince George's,2706,Prince George's Precinct 05-003,217,785,70,2489,2706,1,0.08019216555801921,0.9198078344419808,1851,0.2900960827790096,0.025868440502586843,0.6840354767184036
1420,Prince George's,6329,Prince George's Precinct 15-005,503,2092,93,5826,6329,1,0.07947543055775004,0.9205245694422499,4144,0.3305419497550956,0.014694264496760942,0.6547637857481434
1421,Prince George's,2130,Prince George's Precinct 03-004,136,803,37,1994,2130,1,0.06384976525821597,0.936150234741784,1290,0.3769953051643192,0.01737089201877934,0.6056338028169014
1422,Prince George's,2572,Prince George's Precinct 03-005,235,649,18,2337,2572,1,0.09136858475894245,0.9086314152410575,1905,0.2523328149300155,0.006998444790046656,0.7406687402799378
1423,Prince George's,3005,Prince George's Precinct 03-003,330,1709,80,2675,3005,1,0.10981697171381032,0.8901830282861897,1216,0.5687188019966722,0.026622296173044926,0.40465890183028286
1424,Prince George's,2643,Prince George's Precinct 07-012,84,972,26,2559,2643,1,0.03178206583427923,0.9682179341657208,1645,0.3677639046538025,0.009837306091562617,0.6223987892546349
1425,Prince George's,1936,Prince George's Precinct 13-013,57,586,31,1879,1936,1,0.029442148760330578,0.9705578512396694,1319,0.30268595041322316,0.016012396694214875,0.681301652892562
1426,Prince George's,2052,Prince George's Precinct 07-013,142,731,44,1910,2052,1,0.06920077972709551,0.9307992202729045,1277,0.3562378167641326,0.021442495126705652,0.6223196881091618
1427,Prince George's,2806,Prince George's Precinct 03-006,90,1126,36,2716,2806,1,0.03207412687099073,0.9679258731290092,1644,0.4012829650748396,0.012829650748396294,0.5858873841767641
1428,Prince George's,2583,Prince George's Precinct 07-015,80,1397,59,2503,2583,1,0.03097173828881146,0.9690282617111885,1127,0.5408439798683701,0.022841656987998452,0.4363143631436314
1429,Prince George's,3410,Prince George's Precinct 07-011,119,1211,39,3291,3410,1,0.034897360703812316,0.9651026392961877,2160,0.35513196480938414,0.011436950146627566,0.6334310850439883
1430,Prince George's,3276,Prince George's Precinct 07-009,309,1181,73,2967,3276,1,0.09432234432234432,0.9056776556776557,2022,0.3605006105006105,0.022283272283272284,0.6172161172161172
1431,Prince George's,3105,Prince George's Precinct 03-002,469,1038,77,2636,3105,1,0.15104669887278582,0.8489533011272141,1990,0.3342995169082126,0.024798711755233495,0.6409017713365539
1432,Prince George's,2246,Prince George's Precinct 07-006,744,710,128,1502,2246,1,0.3312555654496883,0.6687444345503116,1408,0.3161175422974176,0.05699020480854853,0.6268922528940338
1433,Prince George's,2272,Prince George's Precinct 07-008,707,654,85,1565,2272,1,0.31117957746478875,0.6888204225352113,1533,0.2878521126760563,0.037411971830985914,0.6747359154929577
1434,Prince George's,1809,Prince George's Precinct 07-014,794,530,136,1015,1809,1,0.4389165284687673,0.5610834715312327,1143,0.29297954671089,0.07517965726920951,0.6318407960199005
1435,Prince George's,5609,Prince George's Precinct 07-001,1105,2250,193,4504,5609,1,0.19700481369228026,0.8029951863077197,3166,0.4011410233553218,0.03440898555892316,0.564449991085755
1436,Prince George's,2447,Prince George's Precinct 14-007,635,824,76,1812,2447,1,0.2595014303228443,0.7404985696771557,1547,0.33673886391499797,0.031058438904781365,0.6322026971802207
1437,Prince George's,2578,Prince George's Precinct 14-001,1082,812,150,1496,2578,1,0.4197051978277735,0.5802948021722265,1616,0.31497284716834756,0.05818463925523662,0.6268425135764158
1438,Prince George's,1468,Prince George's Precinct 07-016,687,334,111,781,1468,1,0.46798365122615804,0.532016348773842,1023,0.22752043596730245,0.07561307901907358,0.696866485013624
1439,Prince George's,1951,Prince George's Precinct 14-010,641,591,100,1310,1951,1,0.3285494618144541,0.6714505381855459,1260,0.3029215786776012,0.051255766273705795,0.645822655048693
1440,Prince George's,2627,Prince George's Precinct 07-005,1543,576,296,1084,2627,1,0.5873620098972212,0.41263799010277885,1755,0.21926151503616292,0.11267605633802817,0.6680624286258089
1461,Prince George's,5205,Prince George's Precinct 17-007,218,1027,40,4987,5205,1,0.04188280499519693,0.9581171950048031,4138,0.19731027857829012,0.007684918347742555,0.7950048030739674
1462,Prince George's,3271,Prince George's Precinct 17-006,182,409,29,3089,3271,1,0.05564047691837359,0.9443595230816264,2833,0.1250382146132681,0.008865790278202385,0.8660959951085295
1464,Prince George's,6128,Prince George's Precinct 17-011,159,887,50,5969,6128,1,0.025946475195822456,0.9740535248041775,5191,0.14474543080939947,0.008159268929503917,0.8470953002610966
1465,Prince George's,1828,Prince George's Precinct 17-005,235,456,22,1593,1828,1,0.12855579868708972,0.8714442013129103,1350,0.24945295404814005,0.012035010940919038,0.7385120350109409
1466,Prince George's,11788,Prince George's Precinct 17-003,289,625,44,11499,11788,1,0.024516457414319646,0.9754835425856804,11119,0.053020020359687815,0.0037326094333220224,0.9432473702069901
1467,Prince George's,2108,Prince George's Precinct 20-004,210,665,44,1898,2108,1,0.09962049335863378,0.9003795066413662,1399,0.31546489563567365,0.020872865275142316,0.6636622390891841
1468,Prince George's,4017,Prince George's Precinct 13-015,398,1107,61,3619,4017,1,0.0990789146128952,0.9009210853871048,2849,0.27557879014189696,0.015185461787403536,0.7092357480706996
1469,Prince George's,2880,Prince George's Precinct 20-008,292,944,57,2588,2880,1,0.10138888888888889,0.8986111111111111,1879,0.3277777777777778,0.019791666666666666,0.6524305555555555
1470,Prince George's,4069,Prince George's Precinct 14-002,436,1070,70,3633,4069,1,0.10715163430818384,0.8928483656918161,2929,0.26296387318751535,0.01720324404030474,0.7198328827721799
1471,Prince George's,1627,Prince George's Precinct 20-009,352,652,59,1275,1627,1,0.21634910878918254,0.7836508912108174,916,0.4007375537799631,0.03626306084818685,0.56299938537185
1472,Prince George's,3117,Prince George's Precinct 21-013,555,939,65,2562,3117,1,0.17805582290664101,0.821944177093359,2113,0.3012512030798845,0.02085338466474174,0.6778954122553738
1473,Prince George's,2475,Prince George's Precinct 10-011,490,571,60,1985,2475,1,0.19797979797979798,0.802020202020202,1844,0.2307070707070707,0.024242424242424242,0.7450505050505051
1474,Prince George's,3268,Prince George's Precinct 14-008,577,497,41,2691,3268,1,0.17656058751529988,0.8234394124847001,2730,0.15208078335373318,0.012545899632802938,0.8353733170134638
1475,Prince George's,1816,Prince George's Precinct 10-010,503,504,64,1313,1816,1,0.27698237885462557,0.7230176211453745,1248,0.2775330396475771,0.03524229074889868,0.6872246696035242
1503,Prince George's,4719,Prince George's Precinct 01-001,1090,1011,215,3629,4719,1,0.23098114007204917,0.7690188599279508,3493,0.21424030514939607,0.04556050010595465,0.7401991947446492
1506,Prince George's,3119,Prince George's Precinct 01-004,1032,669,180,2087,3119,1,0.3308752805386342,0.6691247194613659,2270,0.21449182430266112,0.05771080474511061,0.7277973709522283
1507,Prince George's,3959,Prince George's Precinct 10-013,1179,1159,182,2780,3959,1,0.2978024753725688,0.7021975246274311,2618,0.2927506946198535,0.04597120484970952,0.661278100530437
1508,Prince George's,3293,Prince George's Precinct 10-005,2310,863,412,983,3293,1,0.7014880048587914,0.29851199514120863,2018,0.2620710598238688,0.12511387792286668,0.6128150622532645
1515,Prince George's,3641,Prince George's Precinct 10-006,792,1113,155,2849,3641,1,0.2175226586102719,0.7824773413897281,2373,0.3056852513045866,0.04257072232903049,0.6517440263663828
1516,Prince George's,5674,Prince George's Precinct 10-012,1116,1372,154,4558,5674,1,0.19668664081776524,0.8033133591822348,4148,0.24180472329925978,0.027141346492774058,0.7310539302079662
1517,Prince George's,2589,Prince George's Precinct 10-008,672,467,98,1917,2589,1,0.25955967555040554,0.7404403244495944,2024,0.18037852452684433,0.03785245268443414,0.7817690227887215
1518,Prince George's,2312,Prince George's Precinct 10-007,684,561,91,1628,2312,1,0.2958477508650519,0.7041522491349481,1660,0.2426470588235294,0.0393598615916955,0.7179930795847751
1541,Prince George's,4015,Prince George's Precinct 17-001,867,1155,63,3148,4015,1,0.21594022415940226,0.7840597758405977,2797,0.2876712328767123,0.01569115815691158,0.696637608966376
1542,Prince George's,4299,Prince George's Precinct 17-004,184,694,39,4115,4299,1,0.04280065131425913,0.9571993486857409,3566,0.16143289137008607,0.009071877180739707,0.8294952314491743
1543,Prince George's,4706,Prince George's Precinct 16-004,679,900,96,4027,4706,1,0.14428389290267743,0.8557161070973226,3710,0.19124521886952825,0.020399490012749683,0.7883552911177221
1544,Prince George's,2240,Prince George's Precinct 17-002,384,649,68,1856,2240,1,0.17142857142857143,0.8285714285714286,1523,0.2897321428571429,0.030357142857142857,0.6799107142857143
1545,Prince George's,2034,Prince George's Precinct 02-002,261,506,51,1773,2034,1,0.12831858407079647,0.8716814159292036,1477,0.2487708947885939,0.025073746312684365,0.7261553588987217
1547,Prince George's,951,Prince George's Precinct 16-002,359,276,57,592,951,1,0.3774973711882229,0.6225026288117771,618,0.2902208201892745,0.05993690851735016,0.6498422712933754
1548,Prince George's,4706,Prince George's Precinct 16-003,1856,1470,218,2850,4706,1,0.3943901402464938,0.6056098597535061,3018,0.3123671908202295,0.046323841903952404,0.6413089672758181
1549,Prince George's,154,Prince George's Precinct 16-005,43,41,10,111,154,1,0.2792207792207792,0.7207792207792207,103,0.2662337662337662,0.06493506493506493,0.6688311688311688
1550,Prince George's,6797,Prince George's Precinct 17-010,330,1085,64,6467,6797,1,0.048550831249080474,0.9514491687509196,5648,0.1596292481977343,0.009415918787700456,0.8309548330145653
1551,Prince George's,5527,Prince George's Precinct 17-008,1048,887,67,4479,5527,1,0.1896146191423919,0.8103853808576081,4573,0.16048489234666183,0.012122308666546046,0.8273927989867921
1552,Prince George's,3704,Prince George's Precinct 17-009,589,519,47,3115,3704,1,0.1590172786177106,0.8409827213822895,3138,0.14011879049676026,0.012688984881209503,0.8471922246220303
1553,Prince George's,1964,Prince George's Precinct 19-003,1471,755,112,493,1964,1,0.7489816700610998,0.2510183299389002,1097,0.3844195519348269,0.05702647657841141,0.5585539714867617
1554,Prince George's,465,Prince George's Precinct 21-012,342,213,54,123,465,1,0.7354838709677419,0.2645161290322581,198,0.45806451612903226,0.11612903225806452,0.4258064516129032
1555,Prince George's,10748,Prince George's Precinct 21-017,6779,323,29,3969,10748,1,0.6307219947897283,0.36927800521027165,10396,0.030052102716784518,0.002698176404912542,0.967249720878303
1559,Prince George's,5990,Prince George's Precinct 17-012,431,709,51,5559,5990,1,0.07195325542570952,0.9280467445742905,5230,0.11836393989983306,0.008514190317195325,0.8731218697829716
1565,Prince George's,2857,Prince George's Precinct 21-005,441,518,80,2416,2857,1,0.1543577178858943,0.8456422821141057,2259,0.18130906545327266,0.0280014000700035,0.7906895344767239
1566,Prince George's,2323,Prince George's Precinct 21-015,1101,357,74,1222,2323,1,0.47395609126130006,0.5260439087387,1892,0.15368058544984933,0.031855359448988374,0.8144640551011623
1567,Prince George's,1633,Prince George's Precinct 21-014,475,483,86,1158,1633,1,0.2908756889161053,0.7091243110838946,1064,0.29577464788732394,0.052663808940600125,0.6515615431720759
1568,Prince George's,5119,Prince George's Precinct 01-003,746,1006,94,4373,5119,1,0.14573158820082047,0.8542684117991796,4019,0.19652275835124047,0.018362961515921077,0.7851142801328385
1634,Prince George's,2446,Prince George's Precinct 21-007,1279,673,199,1167,2446,1,0.5228945216680294,0.4771054783319706,1574,0.2751430907604252,0.08135731807031889,0.6434995911692559
1635,Prince George's,3916,Prince George's Precinct 02-009,227,926,50,3689,3916,1,0.057967313585291114,0.9420326864147089,2940,0.23646578140960164,0.012768130745658836,0.7507660878447395
1636,Prince George's,3022,Prince George's Precinct 02-010,285,548,39,2737,3022,1,0.0943084050297816,0.9056915949702184,2435,0.1813368630046327,0.012905360688285903,0.8057577763070815
1637,Prince George's,3459,Prince George's Precinct 02-006,329,915,74,3130,3459,1,0.09511419485400405,0.9048858051459959,2470,0.2645273200346921,0.02139346631974559,0.7140792136455623
1638,Prince George's,2119,Prince George's Precinct 02-004,309,525,69,1810,2119,1,0.1458235016517225,0.8541764983482775,1525,0.24775837659273242,0.03256252949504483,0.7196790939122227
1639,Prince George's,3067,Prince George's Precinct 20-007,21,666,15,3046,3067,1,0.006847081838930551,0.9931529181610694,2386,0.21715030974894034,0.00489077274209325,0.7779589175089664
1640,Prince George's,2332,Prince George's Precinct 20-012,113,496,15,2219,2332,1,0.04845626072041166,0.9515437392795884,1821,0.21269296740994853,0.006432246998284734,0.7808747855917667
1641,Prince George's,1239,Prince George's Precinct 21-009,565,327,56,674,1239,1,0.45601291364003227,0.5439870863599677,856,0.2639225181598063,0.04519774011299435,0.6908797417271993
1642,Prince George's,2546,Prince George's Precinct 20-005,461,598,64,2085,2546,1,0.18106834249803613,0.8189316575019638,1884,0.23487824037706206,0.02513747054202671,0.7399842890809112
1643,Prince George's,2412,Prince George's Precinct 20-006,332,577,49,2080,2412,1,0.13764510779436154,0.8623548922056384,1786,0.2392205638474295,0.0203150912106136,0.7404643449419569
1644,Prince George's,1798,Prince George's Precinct 21-016,304,557,49,1494,1798,1,0.16907675194660735,0.8309232480533927,1192,0.3097886540600667,0.027252502780867632,0.6629588431590656
1645,Prince George's,3234,Prince George's Precinct 21-004,1237,608,127,1997,3234,1,0.38249845392702536,0.6175015460729747,2499,0.18800247371675943,0.03927025355596784,0.7727272727272727
1646,Prince George's,2721,Prince George's Precinct 21-010,1330,606,165,1391,2721,1,0.48879088570378537,0.5112091142962146,1950,0.2227122381477398,0.06063947078280044,0.7166482910694597
1647,Prince George's,850,Prince George's Precinct 01-008,369,189,30,481,850,1,0.43411764705882355,0.5658823529411765,631,0.2223529411764706,0.03529411764705882,0.7423529411764705
1649,Prince George's,2859,Prince George's Precinct 01-005,1391,722,243,1468,2859,1,0.48653375306051067,0.5134662469394893,1894,0.25253585169639736,0.08499475341028331,0.6624693948933194
1650,Prince George's,4986,Prince George's Precinct 21-008,194,1019,34,4792,4986,1,0.03890894504612916,0.9610910549538708,3933,0.20437224227837947,0.00681909346169274,0.7888086642599278
1652,Prince George's,3492,Prince George's Precinct 21-003,1976,1186,142,1516,3492,1,0.565864833906071,0.434135166093929,2164,0.3396334478808706,0.04066437571592211,0.6197021764032073
1653,Prince George's,2659,Prince George's Precinct 21-006,1934,889,160,725,2659,1,0.7273411056788266,0.27265889432117335,1610,0.3343362166227905,0.06017299736743136,0.6054907860097781
1654,Prince George's,2024,Prince George's Precinct 01-002,921,406,120,1103,2024,1,0.4550395256916996,0.5449604743083004,1498,0.20059288537549408,0.05928853754940711,0.7401185770750988
1655,Prince George's,1731,Prince George's Precinct 01-006,330,551,64,1401,1731,1,0.19064124783362218,0.8093587521663779,1116,0.31831311380704796,0.03697284806470248,0.6447140381282496
1656,Prince George's,2436,Prince George's Precinct 13-003,24,751,27,2412,2436,1,0.009852216748768473,0.9901477832512315,1658,0.30829228243021345,0.011083743842364532,0.680623973727422
1657,Prince George's,1716,Prince George's Precinct 20-002,186,377,42,1530,1716,1,0.10839160839160839,0.8916083916083916,1297,0.2196969696969697,0.024475524475524476,0.7558275058275058
1658,Prince George's,957,Prince George's Precinct 20-013,19,167,11,938,957,1,0.019853709508881923,0.9801462904911181,779,0.17450365726227796,0.011494252873563218,0.8140020898641588
1659,Prince George's,1875,Prince George's Precinct 20-003,26,679,21,1849,1875,1,0.013866666666666666,0.9861333333333333,1175,0.3621333333333333,0.0112,0.6266666666666667
1660,Prince George's,2857,Prince George's Precinct 20-011,168,750,27,2689,2857,1,0.05880294014700735,0.9411970598529926,2080,0.2625131256562828,0.009450472523626182,0.728036401820091
1661,Prince George's,3387,Prince George's Precinct 20-001,567,807,82,2820,3387,1,0.16740478299379982,0.8325952170062002,2498,0.2382639503985828,0.02421021552996752,0.7375258340714497
1662,Prince George's,3358,Prince George's Precinct 21-018,545,838,56,2813,3358,1,0.16229898749255509,0.8377010125074449,2464,0.2495533055390113,0.016676593210244194,0.7337701012507445
1663,Prince George's,3792,Prince George's Precinct 21-011,512,827,72,3280,3792,1,0.1350210970464135,0.8649789029535865,2893,0.21809071729957805,0.0189873417721519,0.76292194092827
1664,Prince George's,2484,Prince George's Precinct 20-010,566,541,78,1918,2484,1,0.2278582930756844,0.7721417069243156,1865,0.2177938808373591,0.03140096618357488,0.750805152979066
1665,Prince George's,3859,Prince George's Precinct 13-005,536,1417,55,3323,3859,1,0.1388960870691889,0.8611039129308111,2387,0.36719357346462816,0.014252396994039906,0.618554029541332
1666,Prince George's,3469,Prince George's Precinct 10-001,531,702,45,2938,3469,1,0.15307004900547708,0.846929950994523,2722,0.20236379360046122,0.012972038051311616,0.7846641683482272
1667,Prince George's,4592,Prince George's Precinct 10-002,1524,1056,172,3068,4592,1,0.3318815331010453,0.6681184668989547,3364,0.22996515679442509,0.037456445993031356,0.7325783972125436
1668,Prince George's,3148,Prince George's Precinct 10-004,732,900,74,2416,3148,1,0.23252858958068615,0.7674714104193139,2174,0.28589580686149935,0.023506988564167726,0.6905972045743329
1670,Prince George's,2617,Prince George's Precinct 10-003,1178,489,127,1439,2617,1,0.45013374092472297,0.5498662590752771,2001,0.1868551776843714,0.04852884982804738,0.7646159724875812
1672,Prince George's,4448,Prince George's Precinct 10-009,845,660,79,3603,4448,1,0.18997302158273383,0.8100269784172662,3709,0.14838129496402877,0.017760791366906475,0.8338579136690647
