,COUNTY,VAP,NAME,WVAP,PRES16D,PRES16R,OVAP,TOT_VOTES,factor,WVAP_pct,OVAP_pct,PRES16None,PRES16D_pct,PRES16R_pct,PRES16None_pct
56,Anne Arundel,2236,Anne Arundel Precinct 07-025,1913,610,927,323,2236,1.0,0.8555456171735242,0.14445438282647585,699,0.27280858676207514,0.4145796064400716,0.31261180679785333
57,Anne Arundel,1839,Anne Arundel Precinct 07-003,1501,660,577,338,1839,1.0,0.8162044589450789,0.18379554105492116,602,0.35889070146818924,0.3137574768896139,0.32735182164219684
58,Anne Arundel,2418,Anne Arundel Precinct 07-010,2221,629,983,197,2418,1.0,0.9185277088502894,0.08147229114971051,806,0.2601323407775021,0.4065343258891646,0.3333333333333333
59,Anne Arundel,2785,Anne Arundel Precinct 07-019,2513,344,521,272,2785,1.0,0.9023339317773789,0.09766606822262118,1920,0.12351885098743268,0.18707360861759426,0.6894075403949731
60,Anne Arundel,2923,Anne Arundel Precinct 07-006,2723,716,1217,200,2923,1.0,0.9315771467670202,0.06842285323297982,990,0.24495381457406773,0.4163530619226822,0.3386931235032501
340,Anne Arundel,3247,Anne Arundel Precinct 07-009,2512,635,753,735,3247,1.0,0.7736372035725285,0.2263627964274715,1859,0.19556513704958423,0.23190637511549123,0.5725284878349245
350,Anne Arundel,2407,Anne Arundel Precinct 07-021,2072,603,1067,335,2407,1.0,0.8608226007478189,0.13917739925218114,737,0.25051931865392607,0.4432904029912754,0.3061902783547985
351,Anne Arundel,2960,Anne Arundel Precinct 07-001,2718,759,1207,242,2960,1.0,0.9182432432432432,0.08175675675675675,994,0.25641891891891894,0.4077702702702703,0.3358108108108108
595,Anne Arundel,2234,Anne Arundel Precinct 03-013,2120,441,1260,114,2234,1.0,0.9489704565801254,0.051029543419874666,533,0.19740376007162042,0.5640107430617726,0.238585496866607
596,Anne Arundel,2342,Anne Arundel Precinct 03-018,2095,504,1229,247,2342,1.0,0.894534585824082,0.10546541417591802,609,0.215200683176772,0.5247651579846285,0.2600341588385995
597,Anne Arundel,2290,Anne Arundel Precinct 03-016,2008,494,923,282,2290,1.0,0.8768558951965065,0.12314410480349346,873,0.21572052401746725,0.40305676855895195,0.3812227074235808
598,Anne Arundel,2081,Anne Arundel Precinct 03-001,1849,477,975,232,2081,1.0,0.8885151369533878,0.1114848630466122,629,0.22921672272945698,0.4685247477174435,0.30225852955309945
599,Anne Arundel,3428,Anne Arundel Precinct 03-003,2995,682,1320,433,3428,1.0,0.8736872812135356,0.1263127187864644,1426,0.19894982497082847,0.38506417736289383,0.4159859976662777
600,Anne Arundel,2683,Anne Arundel Precinct 03-021,2255,657,979,428,2683,1.0,0.8404770778978755,0.1595229221021245,1047,0.2448751397689154,0.364890048453224,0.3902348117778606
601,Anne Arundel,2353,Anne Arundel Precinct 03-007,2050,573,920,303,2353,1.0,0.8712282192945177,0.12877178070548237,860,0.24351891202719933,0.3909902252443689,0.3654908627284318
602,Anne Arundel,1767,Anne Arundel Precinct 03-020,1677,357,926,90,1767,1.0,0.9490662139219015,0.050933786078098474,484,0.20203735144312393,0.5240520656479909,0.2739105829088851
603,Anne Arundel,2826,Anne Arundel Precinct 03-024,2556,613,1073,270,2826,1.0,0.9044585987261147,0.09554140127388536,1140,0.21691436659589525,0.3796886058032555,0.4033970276008493
604,Anne Arundel,2071,Anne Arundel Precinct 03-019,1963,383,1090,108,2071,1.0,0.9478512795750845,0.0521487204249155,598,0.18493481409946885,0.5263157894736842,0.28874939642684694
605,Anne Arundel,1896,Anne Arundel Precinct 03-014,1804,352,773,92,1896,1.0,0.9514767932489452,0.04852320675105485,771,0.18565400843881857,0.40770042194092826,0.40664556962025317
606,Anne Arundel,1673,Anne Arundel Precinct 03-002,1598,315,617,75,1673,1.0,0.9551703526598924,0.04482964734010759,741,0.18828451882845187,0.36879856545128514,0.442916915720263
607,Anne Arundel,2247,Anne Arundel Precinct 03-010,2134,443,1231,113,2247,1.0,0.94971072541166,0.05028927458834001,573,0.19715175789942144,0.5478415665331553,0.25500667556742324
608,Anne Arundel,2451,Anne Arundel Precinct 03-011,2354,514,1336,97,2451,1.0,0.9604243166054671,0.039575683394532844,601,0.20971032231742145,0.5450836393308853,0.2452060383516932
609,Anne Arundel,1573,Anne Arundel Precinct 03-015,1519,333,889,54,1573,1.0,0.9656706929434202,0.034329307056579786,351,0.21169739351557534,0.5651621106166561,0.2231404958677686
610,Anne Arundel,2235,Anne Arundel Precinct 03-012,2128,451,1243,107,2235,1.0,0.9521252796420582,0.04787472035794183,541,0.2017897091722595,0.5561521252796421,0.24205816554809845
616,Anne Arundel,1837,Anne Arundel Precinct 05-014,1658,557,687,179,1837,1.0,0.9025585193249864,0.09744148067501361,593,0.30321175830157865,0.3739793140990746,0.32280892759934676
617,Anne Arundel,1098,Anne Arundel Precinct 05-034,1013,391,446,85,1098,1.0,0.9225865209471766,0.07741347905282331,261,0.3561020036429873,0.40619307832422585,0.23770491803278687
618,Anne Arundel,1456,Anne Arundel Precinct 05-016,1317,457,470,139,1456,1.0,0.904532967032967,0.09546703296703296,529,0.31387362637362637,0.3228021978021978,0.3633241758241758
619,Anne Arundel,1144,Anne Arundel Precinct 05-009,1105,436,472,39,1144,1.0,0.9659090909090909,0.03409090909090909,236,0.3811188811188811,0.4125874125874126,0.2062937062937063
620,Anne Arundel,1735,Anne Arundel Precinct 03-023,1629,475,795,106,1735,1.0,0.9389048991354467,0.06109510086455332,465,0.2737752161383285,0.45821325648414984,0.2680115273775216
621,Anne Arundel,999,Anne Arundel Precinct 05-010,929,285,394,70,999,1.0,0.92992992992993,0.07007007007007007,320,0.2852852852852853,0.3943943943943944,0.3203203203203203
622,Anne Arundel,1854,Anne Arundel Precinct 03-022,1472,489,766,382,1854,1.0,0.7939590075512406,0.20604099244875945,599,0.26375404530744334,0.41316073354908306,0.32308522114347354
623,Anne Arundel,2079,Anne Arundel Precinct 03-017,1958,388,1099,121,2079,1.0,0.9417989417989417,0.0582010582010582,592,0.18662818662818662,0.5286195286195287,0.28475228475228476
624,Anne Arundel,1898,Anne Arundel Precinct 05-011,1645,616,676,253,1898,1.0,0.8667017913593256,0.1332982086406744,606,0.3245521601685985,0.3561643835616438,0.3192834562697576
625,Anne Arundel,2039,Anne Arundel Precinct 05-004,1832,713,852,207,2039,1.0,0.8984796468857283,0.1015203531142717,474,0.34968121628249144,0.41785188818048064,0.23246689553702796
626,Anne Arundel,1847,Anne Arundel Precinct 05-005,1625,733,638,222,1847,1.0,0.8798050893340552,0.12019491066594477,476,0.39685977260422306,0.3454250135354629,0.25771521386031404
627,Anne Arundel,1366,Anne Arundel Precinct 05-023,1291,489,404,75,1366,1.0,0.945095168374817,0.05490483162518302,473,0.3579795021961933,0.2957540263543192,0.3462664714494876
628,Anne Arundel,1716,Anne Arundel Precinct 05-003,1503,619,695,213,1716,1.0,0.8758741258741258,0.12412587412587413,402,0.36072261072261075,0.40501165501165504,0.23426573426573427
629,Anne Arundel,2381,Anne Arundel Precinct 05-026,1899,1212,1061,482,2381,1.0,0.7975640487190256,0.20243595128097439,108,0.5090298194036119,0.44561108777824443,0.04535909281814364
630,Anne Arundel,2632,Anne Arundel Precinct 05-021,2196,910,989,436,2632,1.0,0.8343465045592705,0.1656534954407295,733,0.34574468085106386,0.3757598784194529,0.2784954407294833
631,Anne Arundel,1760,Anne Arundel Precinct 06-030,1534,795,519,226,1760,1.0,0.8715909090909091,0.12840909090909092,446,0.45170454545454547,0.2948863636363636,0.2534090909090909
632,Anne Arundel,1526,Anne Arundel Precinct 06-025,1416,664,603,110,1526,1.0,0.927916120576671,0.07208387942332896,259,0.4351245085190039,0.3951507208387942,0.16972477064220184
633,Anne Arundel,1818,Anne Arundel Precinct 05-020,1541,624,560,277,1818,1.0,0.8476347634763476,0.15236523652365236,634,0.3432343234323432,0.30803080308030806,0.3487348734873487
634,Anne Arundel,1940,Anne Arundel Precinct 05-028,1748,339,326,192,1940,1.0,0.9010309278350516,0.09896907216494845,1275,0.1747422680412371,0.16804123711340208,0.6572164948453608
635,Anne Arundel,1531,Anne Arundel Precinct 05-027,1364,600,646,167,1531,1.0,0.8909209666884389,0.10907903331156107,285,0.3919007184846506,0.42194644023514044,0.186152841280209
636,Anne Arundel,1702,Anne Arundel Precinct 05-013,1627,597,795,75,1702,1.0,0.9559341950646298,0.04406580493537015,310,0.3507638072855464,0.4670975323149236,0.18213866039952997
637,Anne Arundel,2718,Anne Arundel Precinct 05-018,2265,785,714,453,2718,1.0,0.8333333333333334,0.16666666666666666,1219,0.2888153053715968,0.26269315673289184,0.4484915378955114
638,Anne Arundel,2136,Anne Arundel Precinct 05-022,1936,783,809,200,2136,1.0,0.9063670411985019,0.09363295880149813,544,0.36657303370786515,0.37874531835205993,0.2546816479400749
639,Anne Arundel,2178,Anne Arundel Precinct 05-001,1856,794,941,322,2178,1.0,0.852157943067034,0.14784205693296604,443,0.36455463728191,0.43204775022956843,0.2033976124885216
640,Anne Arundel,2073,Anne Arundel Precinct 05-017,1891,843,859,182,2073,1.0,0.9122045344910757,0.08779546550892427,371,0.40665701881331406,0.4143753014954173,0.1789676796912687
641,Anne Arundel,2525,Anne Arundel Precinct 05-002,2062,920,825,463,2525,1.0,0.8166336633663366,0.18336633663366336,780,0.36435643564356435,0.32673267326732675,0.3089108910891089
654,Anne Arundel,1620,Anne Arundel Precinct 07-026,1426,684,732,194,1620,1.0,0.8802469135802469,0.11975308641975309,204,0.4222222222222222,0.45185185185185184,0.1259259259259259
655,Anne Arundel,2128,Anne Arundel Precinct 04-010,1684,214,153,444,2128,1.0,0.7913533834586466,0.20864661654135339,1761,0.10056390977443609,0.0718984962406015,0.8275375939849624
656,Anne Arundel,2733,Anne Arundel Precinct 04-016,2032,830,469,701,2733,1.0,0.743505305525064,0.25649469447493595,1434,0.30369557263080865,0.17160629345042078,0.5246981339187706
657,Anne Arundel,1530,Anne Arundel Precinct 07-014,1357,607,542,173,1530,1.0,0.8869281045751634,0.1130718954248366,381,0.39673202614379083,0.3542483660130719,0.24901960784313726
658,Anne Arundel,2243,Anne Arundel Precinct 07-016,1754,955,572,489,2243,1.0,0.7819884083816317,0.21801159161836825,716,0.4257690592955863,0.2550156041016496,0.31921533660276413
659,Anne Arundel,1864,Anne Arundel Precinct 07-015,1650,746,732,214,1864,1.0,0.8851931330472103,0.1148068669527897,386,0.4002145922746781,0.3927038626609442,0.20708154506437768
660,Anne Arundel,2124,Anne Arundel Precinct 07-018,1735,770,725,389,2124,1.0,0.8168549905838042,0.18314500941619585,629,0.3625235404896422,0.3413370998116761,0.2961393596986817
661,Anne Arundel,3122,Anne Arundel Precinct 04-023,2305,1160,869,817,3122,1.0,0.7383087764253684,0.26169122357463165,1093,0.37155669442664957,0.2783472133247918,0.35009609224855864
662,Anne Arundel,2399,Anne Arundel Precinct 04-022,1498,886,474,901,2399,1.0,0.6244268445185494,0.3755731554814506,1039,0.3693205502292622,0.19758232596915382,0.433097123801584
663,Anne Arundel,1929,Anne Arundel Precinct 04-008,1617,635,713,312,1929,1.0,0.838258164852255,0.16174183514774496,581,0.32918610679108345,0.3696215655780197,0.3011923276308968
664,Anne Arundel,2249,Anne Arundel Precinct 07-008,1808,619,774,441,2249,1.0,0.8039128501556247,0.19608714984437528,856,0.27523343708314807,0.34415295686971986,0.38061360604713207
665,Anne Arundel,2263,Anne Arundel Precinct 07-007,2076,669,959,187,2263,1.0,0.9173663278833407,0.0826336721166593,635,0.2956252761820592,0.42377375165709236,0.28060097216084845
666,Anne Arundel,1835,Anne Arundel Precinct 07-004,1530,485,689,305,1835,1.0,0.8337874659400545,0.16621253405994552,661,0.26430517711171664,0.3754768392370572,0.36021798365122615
667,Anne Arundel,2323,Anne Arundel Precinct 07-011,1990,160,314,333,2323,1.0,0.8566508824795523,0.14334911752044768,1849,0.06887645286267757,0.13517003874300473,0.7959535083943177
668,Anne Arundel,1659,Anne Arundel Precinct 07-027,1347,706,952,312,1659,1.3782211138819618,0.8119349005424955,0.18806509945750452,1,0.4255575647980711,0.5738396624472574,0.0006027727546714888
669,Anne Arundel,2006,Anne Arundel Precinct 07-013,1841,680,915,165,2006,1.0,0.9177467597208375,0.08225324027916252,411,0.3389830508474576,0.4561316051844467,0.2048853439680957
670,Anne Arundel,2140,Anne Arundel Precinct 07-022,1966,530,836,174,2140,1.0,0.9186915887850468,0.08130841121495327,774,0.24766355140186916,0.39065420560747666,0.3616822429906542
671,Anne Arundel,2009,Anne Arundel Precinct 07-017,1700,521,463,309,2009,1.0,0.8461921353907417,0.15380786460925833,1025,0.25933300149328026,0.2304629168740667,0.5102040816326531
672,Anne Arundel,1853,Anne Arundel Precinct 07-020,1435,703,482,418,1853,1.0,0.7744198596869941,0.22558014031300594,668,0.37938478143550997,0.2601187263896384,0.3604964921748516
673,Anne Arundel,2151,Anne Arundel Precinct 07-024,1764,840,824,387,2151,1.0,0.8200836820083682,0.1799163179916318,487,0.3905160390516039,0.3830776383077638,0.22640632264063226
674,Anne Arundel,2719,Anne Arundel Precinct 04-021,1999,1155,906,720,2719,1.0,0.7351967635159985,0.26480323648400145,658,0.4247885251930857,0.3332107392423685,0.2420007355645458
675,Anne Arundel,1631,Anne Arundel Precinct 06-028,1259,489,624,372,1631,1.0,0.7719190680564071,0.22808093194359289,518,0.2998160637645616,0.3825873697118332,0.31759656652360513
676,Anne Arundel,2014,Anne Arundel Precinct 04-004,1753,645,934,261,2014,1.0,0.8704071499503475,0.12959285004965243,435,0.3202581926514399,0.4637537239324727,0.21598808341608738
677,Anne Arundel,1699,Anne Arundel Precinct 07-023,1518,726,942,181,1699,1.0,0.8934667451442024,0.10653325485579752,31,0.42731018246027075,0.5544437904649794,0.018246027074749854
678,Anne Arundel,2203,Anne Arundel Precinct 07-012,2057,400,529,146,2203,1.0,0.9337267362687245,0.06627326373127554,1274,0.18157058556513844,0.2401270994098956,0.578302315024966
679,Anne Arundel,1374,Anne Arundel Precinct 06-020,1317,521,464,57,1374,1.0,0.9585152838427947,0.04148471615720524,389,0.3791848617176128,0.33770014556040756,0.2831149927219796
680,Anne Arundel,2873,Anne Arundel Precinct 07-005,2447,879,1126,426,2873,1.0,0.8517229376957883,0.14827706230421162,868,0.30595196658545076,0.39192481726418377,0.30212321615036547
681,Anne Arundel,2103,Anne Arundel Precinct 06-019,1955,778,777,148,2103,1.0,0.9296243461721351,0.07037565382786495,548,0.3699476937708036,0.369472182596291,0.2605801236329054
682,Anne Arundel,1864,Anne Arundel Precinct 06-026,1752,801,896,112,1864,1.0,0.9399141630901288,0.060085836909871244,167,0.42972103004291845,0.48068669527896996,0.0895922746781116
683,Anne Arundel,1098,Anne Arundel Precinct 06-027,991,316,471,107,1098,1.0,0.9025500910746812,0.09744990892531877,311,0.2877959927140255,0.42896174863387976,0.28324225865209474
684,Anne Arundel,2583,Anne Arundel Precinct 04-015,2338,858,1091,245,2583,1.0,0.9051490514905149,0.0948509485094851,634,0.3321718931475029,0.42237708091366627,0.2454510259388308
685,Anne Arundel,3191,Anne Arundel Precinct 06-021,2803,571,644,388,3191,1.0,0.8784080225634597,0.12159197743654027,1976,0.17894077091820745,0.20181761203384518,0.6192416170479473
686,Anne Arundel,1255,Anne Arundel Precinct 06-031,1182,461,565,73,1255,1.0,0.9418326693227091,0.05816733067729084,229,0.3673306772908366,0.450199203187251,0.18247011952191236
687,Anne Arundel,3699,Anne Arundel Precinct 04-006,1002,1809,209,2697,3699,1.0,0.2708840227088402,0.7291159772911597,1681,0.48905109489051096,0.05650175723168424,0.4544471478778048
692,Anne Arundel,5212,Anne Arundel Precinct 01-023,1471,444,120,3741,5212,1.0,0.28223330775134303,0.717766692248657,4648,0.0851880276285495,0.023023791250959325,0.8917881811204912
693,Anne Arundel,5070,Anne Arundel Precinct 01-022,3022,2134,1058,2048,5070,1.0,0.5960552268244576,0.4039447731755424,1878,0.4209072978303747,0.20867850098619328,0.37041420118343193
695,Anne Arundel,2020,Anne Arundel Precinct 04-020,1529,804,497,491,2020,1.0,0.7569306930693069,0.24306930693069306,719,0.39801980198019804,0.24603960396039604,0.3559405940594059
696,Anne Arundel,1510,Anne Arundel Precinct 04-005,1100,580,336,410,1510,1.0,0.7284768211920529,0.271523178807947,594,0.3841059602649007,0.22251655629139072,0.3933774834437086
697,Anne Arundel,1589,Anne Arundel Precinct 06-024,1066,814,365,523,1589,1.0,0.670862177470107,0.329137822529893,410,0.512271869100063,0.22970421648835745,0.2580239144115796
698,Anne Arundel,1801,Anne Arundel Precinct 06-010,1437,420,359,364,1801,1.0,0.7978900610771793,0.20210993892282064,1022,0.23320377568017767,0.19933370349805662,0.5674625208217657
699,Anne Arundel,2354,Anne Arundel Precinct 06-003,448,811,110,1906,2354,1.0,0.1903143585386576,0.8096856414613424,1433,0.3445199660152931,0.04672897196261682,0.6087510620220901
700,Anne Arundel,3339,Anne Arundel Precinct 06-022,2543,804,599,796,3339,1.0,0.7616052710392333,0.2383947289607667,1936,0.2407906558849955,0.17939502845163222,0.5798143156633723
701,Anne Arundel,2337,Anne Arundel Precinct 06-014,603,1203,209,1734,2337,1.0,0.25802310654685495,0.7419768934531451,925,0.5147625160462131,0.08943089430894309,0.39580658964484383
702,Anne Arundel,1784,Anne Arundel Precinct 06-004,869,379,90,915,1784,1.0,0.48710762331838564,0.5128923766816144,1315,0.2124439461883408,0.05044843049327354,0.7371076233183856
703,Anne Arundel,1134,Anne Arundel Precinct 06-013,492,535,191,642,1134,1.0,0.43386243386243384,0.5661375661375662,408,0.47178130511463845,0.16843033509700175,0.35978835978835977
704,Anne Arundel,1646,Anne Arundel Precinct 06-002,1480,814,547,166,1646,1.0,0.8991494532199271,0.10085054678007291,285,0.4945321992709599,0.33232077764277035,0.17314702308626975
705,Anne Arundel,1709,Anne Arundel Precinct 06-009,1578,704,541,131,1709,1.0,0.9233469865418373,0.07665301345816267,464,0.41193680514921005,0.3165593914569924,0.27150380339379754
706,Anne Arundel,1407,Anne Arundel Precinct 06-005,1154,542,384,253,1407,1.0,0.820184790334044,0.17981520966595593,481,0.38521677327647474,0.27292110874200426,0.34186211798152094
707,Anne Arundel,1924,Anne Arundel Precinct 06-006,397,639,127,1527,1924,1.0,0.20634095634095634,0.7936590436590436,1158,0.3321205821205821,0.06600831600831601,0.6018711018711018
708,Anne Arundel,1590,Anne Arundel Precinct 06-023,1409,752,477,181,1590,1.0,0.8861635220125786,0.11383647798742139,361,0.4729559748427673,0.3,0.2270440251572327
709,Anne Arundel,2555,Anne Arundel Precinct 06-017,1841,792,436,714,2555,1.0,0.7205479452054795,0.27945205479452057,1327,0.30998043052837576,0.1706457925636008,0.5193737769080234
710,Anne Arundel,1846,Anne Arundel Precinct 06-007,1193,543,196,653,1846,1.0,0.6462621885157096,0.35373781148429034,1107,0.2941495124593716,0.10617551462621885,0.5996749729144095
711,Anne Arundel,2292,Anne Arundel Precinct 06-015,921,693,285,1371,2292,1.0,0.4018324607329843,0.5981675392670157,1314,0.3023560209424084,0.1243455497382199,0.5732984293193717
712,Anne Arundel,1228,Anne Arundel Precinct 06-016,525,598,112,703,1228,1.0,0.42752442996742673,0.5724755700325733,518,0.48697068403908794,0.09120521172638436,0.4218241042345277
713,Anne Arundel,2314,Anne Arundel Precinct 06-001,1951,1090,571,363,2314,1.0,0.8431287813310285,0.15687121866897147,653,0.4710458081244598,0.24675885911840967,0.2821953327571305
714,Anne Arundel,2135,Anne Arundel Precinct 06-012,1373,928,380,762,2135,1.0,0.6430913348946136,0.35690866510538644,827,0.4346604215456675,0.17798594847775176,0.3873536299765808
715,Anne Arundel,1420,Anne Arundel Precinct 06-008,1092,843,402,328,1420,1.0,0.7690140845070422,0.23098591549295774,175,0.5936619718309859,0.2830985915492958,0.12323943661971831
716,Anne Arundel,2303,Anne Arundel Precinct 06-018,1977,912,527,326,2303,1.0,0.8584455058619193,0.14155449413808077,864,0.39600521059487626,0.228831958315241,0.37516283108988274
717,Anne Arundel,6313,Anne Arundel Precinct 06-011,4882,518,228,1431,6313,1.0,0.7733248851576113,0.22667511484238873,5567,0.08205290670045937,0.03611595121178521,0.8818311420877554
718,Anne Arundel,1104,Anne Arundel Precinct 06-029,958,425,436,146,1104,1.0,0.8677536231884058,0.1322463768115942,243,0.384963768115942,0.39492753623188404,0.22010869565217392
768,Anne Arundel,1446,Anne Arundel Precinct 05-007,1323,493,608,123,1446,1.0,0.9149377593360996,0.08506224066390042,345,0.3409405255878285,0.42047026279391425,0.23858921161825727
769,Anne Arundel,1348,Anne Arundel Precinct 02-013,1068,464,560,280,1348,1.0,0.7922848664688428,0.20771513353115728,324,0.34421364985163205,0.41543026706231456,0.2403560830860534
770,Anne Arundel,1465,Anne Arundel Precinct 05-024,1398,514,664,67,1465,1.0,0.9542662116040955,0.04573378839590444,287,0.3508532423208191,0.45324232081911264,0.19590443686006825
771,Anne Arundel,918,Anne Arundel Precinct 05-029,841,228,393,77,918,1.0,0.9161220043572985,0.08387799564270153,297,0.24836601307189543,0.42810457516339867,0.3235294117647059
772,Anne Arundel,1829,Anne Arundel Precinct 05-025,1691,487,675,138,1829,1.0,0.9245489338436303,0.0754510661563696,667,0.26626571897211593,0.36905412793876435,0.3646801530891197
773,Anne Arundel,1771,Anne Arundel Precinct 05-008,1550,687,691,221,1771,1.0,0.8752117447769622,0.12478825522303783,393,0.3879164313946923,0.3901750423489554,0.22190852625635235
774,Anne Arundel,512,Anne Arundel Precinct 05-032,276,310,181,236,512,1.0,0.5390625,0.4609375,21,0.60546875,0.353515625,0.041015625
775,Anne Arundel,1378,Anne Arundel Precinct 05-006,1331,574,601,47,1378,1.0,0.9658925979680697,0.034107402031930335,203,0.41654571843251087,0.4361393323657475,0.14731494920174165
776,Anne Arundel,1402,Anne Arundel Precinct 05-012,1244,472,549,158,1402,1.0,0.8873038516405135,0.11269614835948645,381,0.33666191155492153,0.39158345221112695,0.2717546362339515
777,Anne Arundel,956,Anne Arundel Precinct 05-030,750,295,380,206,956,1.0,0.7845188284518828,0.21548117154811716,281,0.30857740585774057,0.39748953974895396,0.2939330543933054
778,Anne Arundel,1159,Anne Arundel Precinct 03-009,1038,262,516,121,1159,1.0,0.8955996548748921,0.10440034512510785,381,0.22605694564279552,0.4452113891285591,0.3287316652286454
779,Anne Arundel,2203,Anne Arundel Precinct 03-005,1873,700,1025,330,2203,1.0,0.8502042669087608,0.14979573309123922,478,0.3177485247389923,0.4652746255106673,0.21697684975034046
780,Anne Arundel,584,Anne Arundel Precinct 05-031,419,170,199,165,584,1.0,0.7174657534246576,0.2825342465753425,215,0.2910958904109589,0.3407534246575342,0.3681506849315068
781,Anne Arundel,2474,Anne Arundel Precinct 02-020,1732,681,661,742,2474,1.0,0.7000808407437349,0.29991915925626517,1132,0.2752627324171382,0.267178658043654,0.45755860953920774
782,Anne Arundel,1793,Anne Arundel Precinct 02-011,1380,348,493,413,1793,1.0,0.769659788064696,0.23034021193530396,952,0.19408812046848856,0.27495817066369216,0.5309537088678193
783,Anne Arundel,2031,Anne Arundel Precinct 02-012,1669,393,540,362,2031,1.0,0.8217626784835057,0.17823732151649435,1098,0.1935007385524372,0.2658788774002954,0.5406203840472673
784,Anne Arundel,3219,Anne Arundel Precinct 02-019,1615,860,411,1604,3219,1.0,0.501708605156881,0.49829139484311896,1948,0.2671637154395775,0.1276794035414725,0.6051568810189499
785,Anne Arundel,3140,Anne Arundel Precinct 03-008,2252,918,732,888,3140,1.0,0.7171974522292993,0.28280254777070063,1490,0.29235668789808916,0.23312101910828026,0.4745222929936306
786,Anne Arundel,2930,Anne Arundel Precinct 02-010,2396,506,860,534,2930,1.0,0.8177474402730376,0.18225255972696247,1564,0.1726962457337884,0.2935153583617747,0.5337883959044368
787,Anne Arundel,3008,Anne Arundel Precinct 02-022,2642,636,1009,366,3008,1.0,0.8783244680851063,0.12167553191489362,1363,0.21143617021276595,0.33543882978723405,0.453125
788,Anne Arundel,2034,Anne Arundel Precinct 03-025,1099,709,456,935,2034,1.0,0.54031465093412,0.45968534906588004,869,0.34857423795476894,0.22418879056047197,0.4272369714847591
789,Anne Arundel,3117,Anne Arundel Precinct 03-004,2564,675,1122,553,3117,1.0,0.8225858196984279,0.17741418030157202,1320,0.2165543792107796,0.3599615014436959,0.42348411934552455
790,Anne Arundel,4177,Anne Arundel Precinct 03-006,3217,2150,2026,960,4177,1.1730337078651685,0.7701699784534355,0.2298300215465645,1,0.5147234857553268,0.4850371079722289,0.00023940627244433804
791,Anne Arundel,1490,Anne Arundel Precinct 01-002,1350,490,759,140,1490,1.0,0.9060402684563759,0.09395973154362416,241,0.3288590604026846,0.5093959731543625,0.16174496644295303
792,Anne Arundel,1231,Anne Arundel Precinct 01-011,1154,338,610,77,1231,1.0,0.9374492282696995,0.06255077173030058,283,0.2745735174654752,0.49553208773354995,0.22989439480097482
793,Anne Arundel,1787,Anne Arundel Precinct 01-007,1593,371,722,194,1787,1.0,0.8914381645215445,0.1085618354784555,694,0.2076105204252938,0.40402909904868495,0.3883603805260213
794,Anne Arundel,1878,Anne Arundel Precinct 01-001,1569,544,827,309,1878,1.0,0.8354632587859425,0.1645367412140575,507,0.2896698615548456,0.44036208732694354,0.26996805111821087
795,Anne Arundel,1406,Anne Arundel Precinct 01-010,1312,432,635,94,1406,1.0,0.9331436699857752,0.06685633001422475,339,0.30725462304409673,0.4516358463726885,0.2411095305832148
799,Anne Arundel,2426,Anne Arundel Precinct 01-008,2132,529,953,294,2426,1.0,0.8788128606760099,0.12118713932399011,944,0.21805441055234956,0.3928276999175598,0.3891178895300907
800,Anne Arundel,2202,Anne Arundel Precinct 01-004,1450,797,478,752,2202,1.0,0.6584922797456857,0.34150772025431425,927,0.3619436875567666,0.21707538601271573,0.4209809264305177
801,Anne Arundel,2201,Anne Arundel Precinct 01-014,1607,484,694,594,2201,1.0,0.7301226715129486,0.2698773284870513,1023,0.2199000454338937,0.3153112221717401,0.4647887323943662
802,Anne Arundel,4021,Anne Arundel Precinct 01-012,1909,1165,358,2112,4021,1.0,0.4747575230042278,0.5252424769957722,2498,0.2897289231534444,0.0890325789604576,0.621238497886098
803,Anne Arundel,2018,Anne Arundel Precinct 01-015,1685,560,681,333,2018,1.0,0.8349851337958375,0.16501486620416253,777,0.27750247770069375,0.33746283448959363,0.38503468780971256
806,Anne Arundel,1443,Anne Arundel Precinct 01-013,1092,347,285,351,1443,1.0,0.7567567567567568,0.24324324324324326,811,0.24047124047124047,0.19750519750519752,0.5620235620235621
879,Anne Arundel,3468,Anne Arundel Precinct 01-018,2157,1048,612,1311,3468,1.0,0.6219723183391004,0.3780276816608997,1808,0.3021914648212226,0.17647058823529413,0.5213379469434832
880,Anne Arundel,1823,Anne Arundel Precinct 01-017,1402,392,398,421,1823,1.0,0.7690619857377948,0.23093801426220514,1033,0.21503017004936917,0.21832144816236973,0.5666483817882612
881,Anne Arundel,2523,Anne Arundel Precinct 01-016,1828,620,577,695,2523,1.0,0.724534284581847,0.275465715418153,1326,0.24573919936583433,0.22869599682917163,0.525564803804994
909,Anne Arundel,2629,Anne Arundel Precinct 07-002,2349,797,1107,280,2629,1.0,0.893495625713199,0.10650437428680107,725,0.303157093952073,0.4210726511981742,0.27577025484975276
1328,Anne Arundel,1793,Anne Arundel Precinct 04-013,1507,432,707,286,1793,1.0,0.8404907975460123,0.15950920245398773,654,0.24093697713329615,0.3943112102621305,0.36475181260457334
1329,Anne Arundel,2683,Anne Arundel Precinct 02-021,2136,811,1247,547,2683,1.0,0.7961237420797614,0.20387625792023853,625,0.302273574357063,0.46477823332090945,0.23294819232202757
1330,Anne Arundel,1317,Anne Arundel Precinct 05-015,1236,337,426,81,1317,1.0,0.9384965831435079,0.06150341685649203,554,0.25588458618071375,0.3234624145785877,0.42065299924069854
1331,Anne Arundel,1928,Anne Arundel Precinct 02-018,1261,686,412,667,1928,1.0,0.654045643153527,0.345954356846473,830,0.3558091286307054,0.21369294605809128,0.43049792531120334
1332,Anne Arundel,2386,Anne Arundel Precinct 02-015,1415,949,545,971,2386,1.0,0.5930427493713327,0.4069572506286672,892,0.3977367979882649,0.22841575859178542,0.3738474434199497
1333,Anne Arundel,1226,Anne Arundel Precinct 05-033,1052,447,778,174,1226,1.0642919200695047,0.8580750407830342,0.14192495921696574,1,0.3646003262642741,0.634584013050571,0.0008156606851549756
1334,Anne Arundel,2500,Anne Arundel Precinct 02-004,1644,852,673,856,2500,1.0,0.6576,0.3424,975,0.3408,0.2692,0.39
1335,Anne Arundel,2846,Anne Arundel Precinct 02-009,1587,937,506,1259,2846,1.0,0.5576247364722418,0.44237526352775824,1403,0.3292340126493324,0.17779339423752635,0.49297259311314123
1336,Anne Arundel,2844,Anne Arundel Precinct 02-007,2016,932,827,828,2844,1.0,0.7088607594936709,0.2911392405063291,1085,0.32770745428973275,0.29078762306610406,0.38150492264416314
1337,Anne Arundel,2177,Anne Arundel Precinct 01-009,1913,461,825,264,2177,1.0,0.8787322002756086,0.12126779972439136,891,0.21175930179145613,0.378961874138723,0.40927882406982086
1338,Anne Arundel,2304,Anne Arundel Precinct 02-003,1599,591,651,705,2304,1.0,0.6940104166666666,0.3059895833333333,1062,0.2565104166666667,0.2825520833333333,0.4609375
1339,Anne Arundel,3752,Anne Arundel Precinct 02-017,1881,1009,361,1871,3752,1.0,0.5013326226012793,0.4986673773987207,2382,0.26892324093816633,0.09621535181236673,0.6348614072494669
1340,Anne Arundel,4380,Anne Arundel Precinct 02-014,1844,1338,342,2536,4380,1.0,0.42100456621004567,0.5789954337899543,2700,0.30547945205479454,0.07808219178082192,0.6164383561643836
1341,Anne Arundel,1399,Anne Arundel Precinct 02-002,1086,617,512,313,1399,1.0,0.7762687634024303,0.2237312365975697,270,0.4410293066476054,0.365975696926376,0.19299499642601858
1342,Anne Arundel,3009,Anne Arundel Precinct 02-005,1892,739,559,1117,3009,1.0,0.6287803256895979,0.37121967431040215,1711,0.24559654370222667,0.1857760053173812,0.5686274509803921
1343,Anne Arundel,2023,Anne Arundel Precinct 02-006,1608,470,583,415,2023,1.0,0.7948591201186357,0.2051408798813643,970,0.23232822540781017,0.28818586258032625,0.4794859120118636
1344,Anne Arundel,2540,Anne Arundel Precinct 01-003,2035,501,788,505,2540,1.0,0.8011811023622047,0.19881889763779528,1251,0.19724409448818897,0.3102362204724409,0.4925196850393701
1345,Anne Arundel,1582,Anne Arundel Precinct 02-016,1282,344,493,300,1582,1.0,0.8103666245259166,0.18963337547408343,745,0.21744627054361568,0.3116308470290771,0.47092288242730723
1346,Anne Arundel,2689,Anne Arundel Precinct 02-008,2286,624,918,403,2689,1.0,0.8501301599107475,0.1498698400892525,1147,0.23205652658981032,0.3413908516177018,0.42655262179248793
1347,Anne Arundel,1929,Anne Arundel Precinct 04-014,1789,555,745,140,1929,1.0,0.9274235355106273,0.07257646448937273,629,0.28771384136858474,0.38621047174701917,0.3260756868843961
1348,Anne Arundel,1584,Anne Arundel Precinct 05-019,1501,470,657,83,1584,1.0,0.94760101010101,0.052398989898989896,457,0.2967171717171717,0.4147727272727273,0.288510101010101
1602,Anne Arundel,6637,Anne Arundel Precinct 04-007,3576,1118,327,3061,6637,1.0,0.5387976495404551,0.461202350459545,5192,0.16844960072321832,0.04926924815428658,0.7822811511224951
1603,Anne Arundel,2138,Anne Arundel Precinct 04-019,624,1084,134,1514,2138,1.0,0.29186155285313375,0.7081384471468662,920,0.5070159027128157,0.0626753975678204,0.4303086997193639
1604,Anne Arundel,1672,Anne Arundel Precinct 04-011,1012,686,407,660,1672,1.0,0.6052631578947368,0.39473684210526316,579,0.4102870813397129,0.24342105263157895,0.34629186602870815
1605,Anne Arundel,1787,Anne Arundel Precinct 04-012,1244,562,490,543,1787,1.0,0.6961387800783436,0.30386121992165643,735,0.3144935646334639,0.2742025741466144,0.41130386121992163
1606,Anne Arundel,1872,Anne Arundel Precinct 04-003,1469,578,640,403,1872,1.0,0.7847222222222222,0.2152777777777778,654,0.3087606837606838,0.3418803418803419,0.34935897435897434
1607,Anne Arundel,2203,Anne Arundel Precinct 04-002,1531,968,639,672,2203,1.0,0.6949614162505674,0.3050385837494326,596,0.43940081706763506,0.2900590104403087,0.2705401724920563
1608,Anne Arundel,3982,Anne Arundel Precinct 04-024,1617,1296,298,2365,3982,1.0,0.40607734806629836,0.5939226519337016,2388,0.32546459065796085,0.07483676544450026,0.5996986438975389
1609,Anne Arundel,2792,Anne Arundel Precinct 04-018,453,1783,662,2339,2792,1.0,0.16224928366762179,0.8377507163323782,347,0.6386103151862464,0.23710601719197708,0.1242836676217765
1610,Anne Arundel,2335,Anne Arundel Precinct 02-023,1669,837,796,666,2335,1.0,0.7147751605995717,0.28522483940042825,702,0.358458244111349,0.3408993576017131,0.3006423982869379
1611,Anne Arundel,2103,Anne Arundel Precinct 02-024,1550,656,631,553,2103,1.0,0.7370423204945317,0.2629576795054684,816,0.3119353304802663,0.30004755111745124,0.3880171184022825
1612,Anne Arundel,2435,Anne Arundel Precinct 01-020,1182,946,443,1253,2435,1.0,0.4854209445585216,0.5145790554414784,1046,0.3885010266940452,0.18193018480492812,0.4295687885010267
1613,Anne Arundel,2219,Anne Arundel Precinct 01-021,618,1146,197,1601,2219,1.0,0.2785038305543037,0.7214961694456963,876,0.5164488508337088,0.08877872915727805,0.3947724200090131
1614,Anne Arundel,2392,Anne Arundel Precinct 01-019,966,965,375,1426,2392,1.0,0.40384615384615385,0.5961538461538461,1052,0.40342809364548493,0.15677257525083613,0.4397993311036789
1615,Anne Arundel,1877,Anne Arundel Precinct 01-005,1116,665,428,761,1877,1.0,0.5945657964837506,0.4054342035162493,784,0.3542887586574321,0.22802344166222696,0.417687799680341
1616,Anne Arundel,1391,Anne Arundel Precinct 01-024,699,627,270,692,1391,1.0,0.5025161754133717,0.4974838245866283,494,0.4507548526240115,0.19410496046010065,0.35514018691588783
1617,Anne Arundel,1706,Anne Arundel Precinct 02-001,1287,505,553,419,1706,1.0,0.7543962485345839,0.2456037514654162,648,0.29601406799531066,0.32415005861664714,0.3798358733880422
1618,Anne Arundel,2031,Anne Arundel Precinct 01-006,1005,1014,421,1026,2031,1.0,0.4948301329394387,0.5051698670605613,596,0.49926144756277696,0.20728705071393402,0.29345150172328904
1673,Anne Arundel,3177,Anne Arundel Precinct 04-017,1534,956,334,1643,3177,1.0,0.4828454516839786,0.5171545483160214,1887,0.300912810827825,0.1051306263770853,0.5939565627950897
1674,Anne Arundel,2642,Anne Arundel Precinct 04-001,1022,1035,311,1620,2642,1.0,0.38682816048448143,0.6131718395155186,1296,0.39174867524602575,0.11771385314155942,0.49053747161241484
1677,Anne Arundel,2646,Anne Arundel Precinct 04-009,961,1761,320,1685,2646,1.0,0.36318972033257746,0.6368102796674225,565,0.6655328798185941,0.12093726379440665,0.21352985638699926
