,COUNTY,VAP,NAME,WVAP,SEN12PD_BC,SEN12PD_CM,OVAP,TOT_VOTES,factor,WVAP_pct,OVAP_pct,SEN12PDNone,SEN12PD_BC_pct,SEN12PD_CM_pct,SEN12PDNone_pct
556,Baltimore City,1090,Baltimore City Precinct 26-028,142,64,40,948,1090,1,0.13027522935779817,0.8697247706422019,986,0.05871559633027523,0.03669724770642202,0.9045871559633027
557,Baltimore City,1429,Baltimore City Precinct 26-027,322,89,38,1107,1429,1,0.22533240027991602,0.7746675997200839,1302,0.0622813156053184,0.026592022393282014,0.9111266620013996
558,Baltimore City,1467,Baltimore City Precinct 27-007,472,93,21,995,1467,1,0.321745057941377,0.678254942058623,1353,0.06339468302658487,0.014314928425357873,0.9222903885480572
559,Baltimore City,985,Baltimore City Precinct 26-030,419,65,13,566,985,1,0.42538071065989846,0.5746192893401015,907,0.06598984771573604,0.013197969543147208,0.9208121827411168
574,Baltimore City,502,Baltimore City Precinct 26-001,417,9,1,85,502,1,0.8306772908366534,0.1693227091633466,492,0.017928286852589643,0.00199203187250996,0.9800796812749004
575,Baltimore City,2426,Baltimore City Precinct 26-002,1008,65,8,1418,2426,1,0.4154987633965375,0.5845012366034625,2353,0.02679307502061006,0.0032976092333058533,0.9699093157460841
576,Baltimore City,2095,Baltimore City Precinct 26-003,1404,56,2,691,2095,1,0.6701670644391408,0.3298329355608592,2037,0.02673031026252983,0.0009546539379474941,0.9723150357995227
581,Baltimore City,782,Baltimore City Precinct 26-005,514,35,5,268,782,1,0.6572890025575447,0.34271099744245526,742,0.04475703324808184,0.00639386189258312,0.948849104859335
582,Baltimore City,1623,Baltimore City Precinct 26-004,1098,39,2,525,1623,1,0.6765249537892791,0.3234750462107209,1582,0.024029574861367836,0.0012322858903265558,0.9747381392483057
583,Baltimore City,1434,Baltimore City Precinct 26-007,799,29,2,635,1434,1,0.5571827057182706,0.44281729428172945,1403,0.020223152022315203,0.001394700139470014,0.9783821478382148
584,Baltimore City,1562,Baltimore City Precinct 26-014,1050,19,1,512,1562,1,0.6722151088348272,0.32778489116517284,1542,0.012163892445582587,0.0006402048655569782,0.9871959026888605
585,Baltimore City,1463,Baltimore City Precinct 26-015,116,106,20,1347,1463,1,0.07928913192071087,0.9207108680792891,1337,0.07245386192754613,0.01367053998632946,0.9138755980861244
586,Baltimore City,4697,Baltimore City Precinct 26-029,597,237,143,4100,4697,1,0.12710240579093038,0.8728975942090696,4317,0.050457738982329144,0.03044496487119438,0.9190972961464765
805,Baltimore City,3265,Baltimore City Precinct 25-005,822,119,19,2443,3265,1,0.2517611026033691,0.748238897396631,3127,0.03644716692189893,0.005819295558958652,0.9577335375191425
807,Baltimore City,2660,Baltimore City Precinct 25-008,74,139,20,2586,2660,1,0.027819548872180452,0.9721804511278196,2501,0.05225563909774436,0.007518796992481203,0.9402255639097744
808,Baltimore City,1089,Baltimore City Precinct 25-009,9,99,8,1080,1089,1,0.008264462809917356,0.9917355371900827,982,0.09090909090909091,0.0073461891643709825,0.9017447199265382
809,Baltimore City,1595,Baltimore City Precinct 25-010,46,98,20,1549,1595,1,0.02884012539184953,0.9711598746081505,1477,0.061442006269592474,0.012539184952978056,0.9260188087774295
810,Baltimore City,3555,Baltimore City Precinct 25-003,2570,79,12,985,3555,1,0.7229254571026723,0.2770745428973277,3464,0.022222222222222223,0.0033755274261603376,0.9744022503516174
811,Baltimore City,929,Baltimore City Precinct 20-009,527,23,3,402,929,1,0.5672766415500539,0.4327233584499462,903,0.024757804090419805,0.0032292787944025836,0.9720129171151776
812,Baltimore City,1049,Baltimore City Precinct 20-005,28,88,19,1021,1049,1,0.02669208770257388,0.9733079122974261,942,0.08388941849380362,0.01811248808388942,0.897998093422307
813,Baltimore City,3568,Baltimore City Precinct 25-004,2774,101,10,794,3568,1,0.7774663677130045,0.22253363228699552,3457,0.028307174887892375,0.002802690582959641,0.968890134529148
814,Baltimore City,756,Baltimore City Precinct 20-010,333,23,6,423,756,1,0.44047619047619047,0.5595238095238095,727,0.03042328042328042,0.007936507936507936,0.9616402116402116
815,Baltimore City,2322,Baltimore City Precinct 20-003,54,117,60,2268,2322,1,0.023255813953488372,0.9767441860465116,2145,0.050387596899224806,0.025839793281653745,0.9237726098191215
816,Baltimore City,2303,Baltimore City Precinct 20-011,848,58,11,1455,2303,1,0.36821537125488496,0.6317846287451151,2234,0.02518454190186713,0.004776378636561007,0.9700390794615719
817,Baltimore City,950,Baltimore City Precinct 20-002,70,47,5,880,950,1,0.07368421052631578,0.9263157894736842,898,0.049473684210526316,0.005263157894736842,0.9452631578947368
818,Baltimore City,1760,Baltimore City Precinct 16-013,14,167,49,1746,1760,1,0.007954545454545454,0.9920454545454546,1544,0.09488636363636363,0.02784090909090909,0.8772727272727273
819,Baltimore City,1950,Baltimore City Precinct 16-012,10,146,42,1940,1950,1,0.005128205128205128,0.9948717948717949,1762,0.07487179487179488,0.021538461538461538,0.9035897435897436
820,Baltimore City,240,Baltimore City Precinct 20-004,4,24,4,236,240,1,0.016666666666666666,0.9833333333333333,212,0.1,0.016666666666666666,0.8833333333333333
821,Baltimore City,1495,Baltimore City Precinct 16-008,24,108,45,1471,1495,1,0.016053511705685617,0.9839464882943144,1342,0.07224080267558529,0.030100334448160536,0.8976588628762542
822,Baltimore City,901,Baltimore City Precinct 26-031,516,45,10,385,901,1,0.5726970033296337,0.42730299667036625,846,0.049944506104328525,0.011098779134295227,0.9389567147613762
826,Baltimore City,2719,Baltimore City Precinct 27-008,1192,181,24,1527,2719,1,0.4383964692901802,0.5616035307098198,2514,0.06656859139389482,0.008826774549466716,0.9246046340566385
827,Baltimore City,2670,Baltimore City Precinct 27-011,1688,142,29,982,2670,1,0.6322097378277154,0.36779026217228467,2499,0.05318352059925094,0.010861423220973783,0.9359550561797753
828,Baltimore City,842,Baltimore City Precinct 27-010,645,47,6,197,842,1,0.7660332541567696,0.2339667458432304,789,0.055819477434679333,0.007125890736342043,0.9370546318289786
876,Baltimore City,1038,Baltimore City Precinct 12-011,130,73,25,908,1038,1,0.1252408477842004,0.8747591522157996,940,0.07032755298651253,0.024084778420038536,0.905587668593449
877,Baltimore City,1718,Baltimore City Precinct 12-008,988,121,22,730,1718,1,0.5750873108265425,0.42491268917345754,1575,0.07043073341094296,0.012805587892898719,0.9167636786961583
878,Baltimore City,1916,Baltimore City Precinct 12-010,382,104,39,1534,1916,1,0.19937369519832984,0.8006263048016702,1773,0.054279749478079335,0.02035490605427975,0.925365344467641
882,Baltimore City,1139,Baltimore City Precinct 25-011,672,26,2,467,1139,1,0.5899912203687445,0.4100087796312555,1111,0.0228270412642669,0.001755926251097454,0.9754170324846356
883,Baltimore City,2273,Baltimore City Precinct 25-012,1279,36,6,994,2273,1,0.5626924769027717,0.4373075230972283,2231,0.01583809942806863,0.0026396832380114386,0.98152221733392
884,Baltimore City,1483,Baltimore City Precinct 25-014,468,29,6,1015,1483,1,0.3155765340525961,0.6844234659474039,1448,0.019554956169925825,0.004045853000674309,0.9763991908293999
885,Baltimore City,1262,Baltimore City Precinct 25-013,750,31,9,512,1262,1,0.5942947702060222,0.40570522979397783,1222,0.02456418383518225,0.0071315372424722665,0.9683042789223455
886,Baltimore City,1628,Baltimore City Precinct 25-015,701,42,9,927,1628,1,0.4305896805896806,0.5694103194103194,1577,0.025798525798525797,0.005528255528255528,0.9686732186732187
887,Baltimore City,2415,Baltimore City Precinct 25-016,1616,46,4,799,2415,1,0.6691511387163561,0.3308488612836439,2365,0.01904761904761905,0.0016563146997929607,0.979296066252588
888,Baltimore City,2673,Baltimore City Precinct 24-004,2448,107,8,225,2673,1,0.9158249158249159,0.08417508417508418,2558,0.040029928918817806,0.0029928918817807705,0.9569771791994014
889,Baltimore City,878,Baltimore City Precinct 24-002,775,44,5,103,878,1,0.8826879271070615,0.11731207289293849,829,0.05011389521640091,0.0056947608200455585,0.9441913439635535
890,Baltimore City,722,Baltimore City Precinct 24-001,632,55,4,90,722,1,0.8753462603878116,0.12465373961218837,663,0.07617728531855955,0.00554016620498615,0.9182825484764543
891,Baltimore City,1728,Baltimore City Precinct 24-003,1531,119,13,197,1728,1,0.8859953703703703,0.11400462962962964,1596,0.06886574074074074,0.007523148148148148,0.9236111111111112
892,Baltimore City,1994,Baltimore City Precinct 03-003,1421,99,8,573,1994,1,0.7126379137412236,0.28736208625877635,1887,0.04964894684052156,0.004012036108324975,0.9463390170511534
893,Baltimore City,3017,Baltimore City Precinct 24-005,2786,149,18,231,3017,1,0.9234338747099768,0.0765661252900232,2850,0.04938680808750414,0.005966191581040769,0.9446470003314551
894,Baltimore City,2635,Baltimore City Precinct 02-003,2167,129,11,468,2635,1,0.8223908918406072,0.1776091081593928,2495,0.048956356736242886,0.004174573055028463,0.9468690702087287
895,Baltimore City,2074,Baltimore City Precinct 02-002,1402,95,13,672,2074,1,0.6759884281581485,0.3240115718418515,1966,0.04580520732883317,0.00626808100289296,0.9479267116682739
896,Baltimore City,2117,Baltimore City Precinct 01-002,1706,111,7,411,2117,1,0.8058573452999528,0.19414265470004724,1999,0.052432687765706185,0.0033065658951346244,0.9442607463391592
897,Baltimore City,1947,Baltimore City Precinct 01-003,1710,57,11,237,1947,1,0.8782742681047766,0.12172573189522343,1879,0.029275808936825885,0.005649717514124294,0.9650744735490498
898,Baltimore City,2617,Baltimore City Precinct 05-001,202,78,23,2415,2617,1,0.07718761941153993,0.92281238058846,2516,0.02980512036683225,0.008788689338937715,0.96140619029423
899,Baltimore City,658,Baltimore City Precinct 10-004,17,36,7,641,658,1,0.025835866261398176,0.9741641337386018,615,0.0547112462006079,0.010638297872340425,0.9346504559270516
900,Baltimore City,5665,Baltimore City Precinct 10-003,789,16,5,4876,5665,1,0.13927625772285968,0.8607237422771403,5644,0.002824360105913504,0.00088261253309797,0.9962930273609886
901,Baltimore City,836,Baltimore City Precinct 03-002,231,21,6,605,836,1,0.27631578947368424,0.7236842105263158,809,0.025119617224880382,0.007177033492822967,0.9677033492822966
913,Baltimore City,2765,Baltimore City Precinct 07-004,124,112,34,2641,2765,1,0.04484629294755877,0.9551537070524412,2619,0.04050632911392405,0.012296564195298372,0.9471971066907776
914,Baltimore City,3497,Baltimore City Precinct 26-010,1389,86,17,2108,3497,1,0.3971975979410924,0.6028024020589077,3394,0.02459250786388333,0.004861309694023448,0.9705461824420932
915,Baltimore City,923,Baltimore City Precinct 26-012,85,30,7,838,923,1,0.09209100758396534,0.9079089924160346,886,0.032502708559046585,0.007583965330444204,0.9599133261105092
916,Baltimore City,3245,Baltimore City Precinct 08-010,18,250,155,3227,3245,1,0.005546995377503852,0.9944530046224962,2840,0.07704160246533127,0.04776579352850539,0.8751926040061633
917,Baltimore City,577,Baltimore City Precinct 08-011,13,53,18,564,577,1,0.022530329289428077,0.9774696707105719,506,0.09185441941074524,0.03119584055459272,0.8769497400346621
918,Baltimore City,1998,Baltimore City Precinct 08-003,70,117,21,1928,1998,1,0.035035035035035036,0.964964964964965,1860,0.05855855855855856,0.010510510510510511,0.9309309309309309
919,Baltimore City,1675,Baltimore City Precinct 26-019,143,139,20,1532,1675,1,0.0853731343283582,0.9146268656716418,1516,0.08298507462686568,0.011940298507462687,0.9050746268656716
920,Baltimore City,783,Baltimore City Precinct 26-020,50,52,24,733,783,1,0.06385696040868455,0.9361430395913155,707,0.06641123882503193,0.03065134099616858,0.9029374201787995
921,Baltimore City,1709,Baltimore City Precinct 26-011,785,34,2,924,1709,1,0.4593329432416618,0.5406670567583383,1673,0.01989467524868344,0.0011702750146284377,0.9789350497366881
922,Baltimore City,1355,Baltimore City Precinct 26-013,1074,28,1,281,1355,1,0.792619926199262,0.207380073800738,1326,0.020664206642066422,0.0007380073800738007,0.9785977859778597
923,Baltimore City,339,Baltimore City Precinct 26-017,33,24,6,306,339,1,0.09734513274336283,0.9026548672566371,309,0.07079646017699115,0.017699115044247787,0.911504424778761
924,Baltimore City,2928,Baltimore City Precinct 26-018,256,78,30,2672,2928,1,0.08743169398907104,0.912568306010929,2820,0.02663934426229508,0.010245901639344262,0.9631147540983607
925,Baltimore City,1249,Baltimore City Precinct 26-016,74,110,29,1175,1249,1,0.059247397918334666,0.9407526020816653,1110,0.08807045636509207,0.02321857485988791,0.88871096877502
982,Baltimore City,2683,Baltimore City Precinct 26-024,242,147,52,2441,2683,1,0.09019754006708908,0.9098024599329109,2484,0.05478941483414089,0.019381289601192696,0.9258292955646664
983,Baltimore City,2299,Baltimore City Precinct 26-025,146,104,15,2153,2299,1,0.06350587211831231,0.9364941278816877,2180,0.045237059591126574,0.006524575902566333,0.948238364506307
984,Baltimore City,1812,Baltimore City Precinct 26-026,482,103,27,1330,1812,1,0.26600441501103755,0.7339955849889624,1682,0.05684326710816777,0.014900662251655629,0.9282560706401766
985,Baltimore City,2585,Baltimore City Precinct 27-005,1273,169,37,1312,2585,1,0.49245647969052225,0.5075435203094778,2379,0.06537717601547388,0.014313346228239845,0.9203094777562862
986,Baltimore City,3355,Baltimore City Precinct 27-006,959,206,72,2396,3355,1,0.28584202682563337,0.7141579731743666,3077,0.061400894187779435,0.021460506706408346,0.9171385991058122
987,Baltimore City,780,Baltimore City Precinct 27-019,33,66,20,747,780,1,0.04230769230769231,0.9576923076923077,694,0.08461538461538462,0.02564102564102564,0.8897435897435897
988,Baltimore City,2289,Baltimore City Precinct 27-015,400,204,59,1889,2289,1,0.17474879860200962,0.8252512013979904,2026,0.0891218872870249,0.025775447793796417,0.8851026649191787
992,Baltimore City,2647,Baltimore City Precinct 27-014,1453,189,42,1194,2647,1,0.5489233094068757,0.4510766905931243,2416,0.07140158670192671,0.015867019267094825,0.9127313940309785
993,Baltimore City,3409,Baltimore City Precinct 27-013,915,160,40,2494,3409,1,0.26840715752420063,0.7315928424757994,3209,0.04693458492226459,0.011733646230566148,0.9413317688471693
994,Baltimore City,1492,Baltimore City Precinct 27-009,843,106,22,649,1492,1,0.5650134048257373,0.43498659517426275,1364,0.07104557640750671,0.014745308310991957,0.9142091152815014
995,Baltimore City,762,Baltimore City Precinct 27-012,550,44,7,212,762,1,0.7217847769028871,0.2782152230971129,711,0.05774278215223097,0.009186351706036745,0.9330708661417323
1014,Baltimore City,751,Baltimore City Precinct 27-037,547,65,13,204,751,1,0.7283621837549934,0.27163781624500666,673,0.08655126498002663,0.017310252996005325,0.8961384820239681
1015,Baltimore City,1727,Baltimore City Precinct 27-038,993,146,21,734,1727,1,0.57498552403011,0.42501447596989,1560,0.08453966415749856,0.012159814707585408,0.903300521134916
1016,Baltimore City,1669,Baltimore City Precinct 27-042,1261,221,17,408,1669,1,0.7555422408627921,0.2444577591372079,1431,0.1324146195326543,0.01018573996405033,0.8573996405032954
1017,Baltimore City,1155,Baltimore City Precinct 27-044,1034,161,8,121,1155,1,0.8952380952380953,0.10476190476190476,986,0.1393939393939394,0.006926406926406926,0.8536796536796537
1018,Baltimore City,1487,Baltimore City Precinct 27-040,1289,167,15,198,1487,1,0.8668459986550101,0.13315400134498992,1305,0.11230665770006724,0.010087424344317418,0.8776059179556154
1019,Baltimore City,742,Baltimore City Precinct 27-039,645,124,8,97,742,1,0.8692722371967655,0.1307277628032345,610,0.16711590296495957,0.01078167115902965,0.8221024258760108
1020,Baltimore City,1929,Baltimore City Precinct 27-041,1446,186,18,483,1929,1,0.749611197511664,0.25038880248833595,1725,0.09642301710730948,0.00933125972006221,0.8942457231726283
1036,Baltimore City,1338,Baltimore City Precinct 09-010,254,93,19,1084,1338,1,0.1898355754857997,0.8101644245142003,1226,0.06950672645739911,0.014200298953662182,0.9162929745889388
1037,Baltimore City,1402,Baltimore City Precinct 09-003,246,130,34,1156,1402,1,0.1754636233951498,0.8245363766048502,1238,0.09272467902995721,0.024251069900142655,0.8830242510699001
1038,Baltimore City,1166,Baltimore City Precinct 09-002,133,81,17,1033,1166,1,0.11406518010291596,0.885934819897084,1068,0.06946826758147513,0.014579759862778732,0.9159519725557461
1039,Baltimore City,1002,Baltimore City Precinct 09-009,76,76,17,926,1002,1,0.07584830339321358,0.9241516966067864,909,0.07584830339321358,0.016966067864271458,0.907185628742515
1040,Baltimore City,1958,Baltimore City Precinct 09-004,484,232,38,1474,1958,1,0.24719101123595505,0.7528089887640449,1688,0.118488253319714,0.01940755873340143,0.8621041879468846
1041,Baltimore City,1717,Baltimore City Precinct 09-005,367,210,46,1350,1717,1,0.21374490390215492,0.786255096097845,1461,0.12230634828188701,0.026790914385556204,0.8509027373325568
1042,Baltimore City,782,Baltimore City Precinct 09-001,41,44,15,741,782,1,0.052429667519181586,0.9475703324808185,723,0.056265984654731455,0.01918158567774936,0.9245524296675192
1043,Baltimore City,970,Baltimore City Precinct 27-036,32,90,16,938,970,1,0.032989690721649485,0.9670103092783505,864,0.09278350515463918,0.016494845360824743,0.8907216494845361
1044,Baltimore City,3261,Baltimore City Precinct 27-035,98,267,47,3163,3261,1,0.03005213124808341,0.9699478687519166,2947,0.08187672493100276,0.01441275682306041,0.9037105182459368
1045,Baltimore City,1481,Baltimore City Precinct 27-026,265,90,31,1216,1481,1,0.17893315327481432,0.8210668467251857,1360,0.06076975016880486,0.020931802835921675,0.9182984469952734
1046,Baltimore City,1722,Baltimore City Precinct 27-027,33,174,36,1689,1722,1,0.01916376306620209,0.980836236933798,1512,0.10104529616724739,0.020905923344947737,0.8780487804878049
1047,Baltimore City,1372,Baltimore City Precinct 27-028,32,120,42,1340,1372,1,0.023323615160349854,0.9766763848396501,1210,0.08746355685131195,0.030612244897959183,0.8819241982507289
1048,Baltimore City,858,Baltimore City Precinct 27-029,10,85,40,848,858,1,0.011655011655011656,0.9883449883449883,733,0.09906759906759907,0.046620046620046623,0.8543123543123543
1049,Baltimore City,1643,Baltimore City Precinct 09-008,18,86,20,1625,1643,1,0.010955569080949483,0.9890444309190505,1537,0.05234327449786975,0.012172854534388313,0.9354838709677419
1050,Baltimore City,1933,Baltimore City Precinct 09-006,142,233,74,1791,1933,1,0.0734609415416451,0.9265390584583549,1626,0.12053802379720642,0.03828246249353337,0.8411795137092603
1051,Baltimore City,1819,Baltimore City Precinct 09-007,152,115,113,1667,1819,1,0.08356239692138538,0.9164376030786147,1591,0.06322155030236394,0.06212204507971413,0.8746564046179219
1052,Baltimore City,1296,Baltimore City Precinct 27-025,35,151,41,1261,1296,1,0.02700617283950617,0.9729938271604939,1104,0.11651234567901235,0.031635802469135804,0.8518518518518519
1053,Baltimore City,1047,Baltimore City Precinct 27-024,138,76,16,909,1047,1,0.1318051575931232,0.8681948424068768,955,0.0725883476599809,0.015281757402101241,0.9121298949379179
1054,Baltimore City,588,Baltimore City Precinct 27-023,30,99,15,558,588,1,0.05102040816326531,0.9489795918367347,474,0.1683673469387755,0.025510204081632654,0.8061224489795918
1055,Baltimore City,1632,Baltimore City Precinct 27-034,121,144,62,1511,1632,1,0.0741421568627451,0.9258578431372549,1426,0.08823529411764706,0.03799019607843137,0.8737745098039216
1056,Baltimore City,2316,Baltimore City Precinct 27-033,564,220,79,1752,2316,1,0.24352331606217617,0.7564766839378239,2017,0.09499136442141623,0.034110535405872194,0.8708981001727115
1057,Baltimore City,2778,Baltimore City Precinct 27-032,1010,213,44,1768,2778,1,0.36357091432685384,0.6364290856731462,2521,0.07667386609071274,0.01583873290136789,0.9074874010079194
1060,Baltimore City,1703,Baltimore City Precinct 27-030,58,133,30,1645,1703,1,0.03405754550792719,0.9659424544920728,1540,0.07809747504403992,0.017615971814445096,0.904286553141515
1061,Baltimore City,2334,Baltimore City Precinct 27-031,141,242,57,2193,2334,1,0.060411311053984576,0.9395886889460154,2035,0.1036846615252785,0.02442159383033419,0.8718937446443873
1062,Baltimore City,2547,Baltimore City Precinct 27-022,207,319,68,2340,2547,1,0.0812720848056537,0.9187279151943463,2160,0.12524538672948568,0.026698076168040832,0.8480565371024735
1063,Baltimore City,2765,Baltimore City Precinct 27-021,234,233,58,2531,2765,1,0.08462929475587704,0.915370705244123,2474,0.08426763110307414,0.020976491862567812,0.894755877034358
1064,Baltimore City,2623,Baltimore City Precinct 27-020,377,194,46,2246,2623,1,0.14372855508959206,0.856271444910408,2383,0.07396111322912695,0.017537171178040413,0.9085017155928327
1066,Baltimore City,1108,Baltimore City Precinct 08-001,657,89,9,451,1108,1,0.5929602888086642,0.40703971119133575,1010,0.08032490974729242,0.008122743682310469,0.9115523465703971
1067,Baltimore City,1540,Baltimore City Precinct 08-002,183,106,15,1357,1540,1,0.11883116883116883,0.8811688311688312,1419,0.06883116883116883,0.00974025974025974,0.9214285714285714
1068,Baltimore City,2756,Baltimore City Precinct 26-021,263,62,15,2493,2756,1,0.09542815674891146,0.9045718432510885,2679,0.022496371552975326,0.00544267053701016,0.9720609579100146
1069,Baltimore City,813,Baltimore City Precinct 26-022,102,46,11,711,813,1,0.12546125461254612,0.8745387453874539,756,0.056580565805658053,0.013530135301353014,0.9298892988929889
1070,Baltimore City,586,Baltimore City Precinct 27-002,406,82,10,180,586,1,0.6928327645051194,0.30716723549488056,494,0.13993174061433447,0.017064846416382253,0.8430034129692833
1071,Baltimore City,2370,Baltimore City Precinct 27-001,734,151,39,1636,2370,1,0.309704641350211,0.6902953586497891,2180,0.06371308016877637,0.016455696202531647,0.919831223628692
1072,Baltimore City,3583,Baltimore City Precinct 27-018,801,186,29,2782,3583,1,0.22355567959810216,0.7764443204018978,3368,0.051911805749372035,0.008093776165224673,0.9399944180854033
1073,Baltimore City,1263,Baltimore City Precinct 27-017,466,145,18,797,1263,1,0.36896278701504354,0.6310372129849564,1100,0.11480601741884403,0.014251781472684086,0.8709422011084719
1074,Baltimore City,642,Baltimore City Precinct 27-003,342,66,14,300,642,1,0.5327102803738317,0.4672897196261682,562,0.102803738317757,0.021806853582554516,0.8753894080996885
1075,Baltimore City,676,Baltimore City Precinct 27-004,338,42,14,338,676,1,0.5,0.5,620,0.0621301775147929,0.020710059171597635,0.9171597633136095
1076,Baltimore City,796,Baltimore City Precinct 27-016,371,76,5,425,796,1,0.46608040201005024,0.5339195979899497,715,0.09547738693467336,0.00628140703517588,0.8982412060301508
1077,Baltimore City,1296,Baltimore City Precinct 26-023,120,69,24,1176,1296,1,0.09259259259259259,0.9074074074074074,1203,0.05324074074074074,0.018518518518518517,0.9282407407407407
1078,Baltimore City,1224,Baltimore City Precinct 15-022,11,111,27,1213,1224,1,0.008986928104575163,0.9910130718954249,1086,0.09068627450980392,0.022058823529411766,0.8872549019607843
1079,Baltimore City,2136,Baltimore City Precinct 15-024,9,135,33,2127,2136,1,0.004213483146067416,0.9957865168539326,1968,0.06320224719101124,0.01544943820224719,0.9213483146067416
1080,Baltimore City,964,Baltimore City Precinct 27-055,16,58,11,948,964,1,0.016597510373443983,0.983402489626556,895,0.06016597510373444,0.011410788381742738,0.9284232365145229
1081,Baltimore City,951,Baltimore City Precinct 15-025,20,52,11,931,951,1,0.02103049421661409,0.9789695057833859,888,0.054679284963196635,0.011566771819137749,0.9337539432176656
1082,Baltimore City,614,Baltimore City Precinct 27-054,17,46,8,597,614,1,0.02768729641693811,0.9723127035830619,560,0.0749185667752443,0.013029315960912053,0.9120521172638436
1083,Baltimore City,804,Baltimore City Precinct 27-058,10,44,21,794,804,1,0.012437810945273632,0.9875621890547264,739,0.05472636815920398,0.026119402985074626,0.9191542288557214
1084,Baltimore City,1983,Baltimore City Precinct 27-053,65,125,33,1918,1983,1,0.03277861825516894,0.9672213817448311,1825,0.06303580433686334,0.01664145234493192,0.9203227433182047
1085,Baltimore City,3199,Baltimore City Precinct 27-052,85,212,73,3114,3199,1,0.026570803376055017,0.973429196623945,2914,0.06627070959674898,0.022819631134729602,0.9109096592685214
1086,Baltimore City,2203,Baltimore City Precinct 15-023,61,129,30,2142,2203,1,0.027689514298683614,0.9723104857013164,2044,0.05855651384475715,0.013617793917385384,0.9278256922378575
1087,Baltimore City,1066,Baltimore City Precinct 13-005,806,54,4,260,1066,1,0.7560975609756098,0.24390243902439024,1008,0.05065666041275797,0.00375234521575985,0.9455909943714822
1088,Baltimore City,1038,Baltimore City Precinct 27-048,156,158,34,882,1038,1,0.15028901734104047,0.8497109826589595,846,0.15221579961464354,0.03275529865125241,0.815028901734104
1089,Baltimore City,827,Baltimore City Precinct 27-043,692,133,13,135,827,1,0.8367593712212817,0.16324062877871826,681,0.1608222490931076,0.015719467956469165,0.8234582829504232
1090,Baltimore City,1140,Baltimore City Precinct 27-050,691,205,32,449,1140,1,0.606140350877193,0.393859649122807,903,0.17982456140350878,0.028070175438596492,0.7921052631578948
1091,Baltimore City,390,Baltimore City Precinct 27-051,146,36,1,244,390,1,0.37435897435897436,0.6256410256410256,353,0.09230769230769231,0.002564102564102564,0.9051282051282051
1092,Baltimore City,2674,Baltimore City Precinct 27-049,2164,363,34,510,2674,1,0.8092744951383695,0.1907255048616305,2277,0.1357516828721017,0.012715033657442034,0.8515332834704562
1094,Baltimore City,777,Baltimore City Precinct 13-006,30,71,28,747,777,1,0.03861003861003861,0.9613899613899614,678,0.09137709137709138,0.036036036036036036,0.8725868725868726
1095,Baltimore City,1244,Baltimore City Precinct 13-004,1098,72,5,146,1244,1,0.882636655948553,0.11736334405144695,1167,0.05787781350482315,0.0040192926045016075,0.9381028938906752
1096,Baltimore City,2273,Baltimore City Precinct 13-003,1980,116,17,293,2273,1,0.8710954685437747,0.12890453145622524,2140,0.05103387593488781,0.007479102507699076,0.9414870215574132
1097,Baltimore City,2199,Baltimore City Precinct 13-011,1953,132,10,246,2199,1,0.888130968622101,0.11186903137789904,2057,0.06002728512960437,0.004547521600727604,0.935425193269668
1098,Baltimore City,1290,Baltimore City Precinct 13-012,1174,105,10,116,1290,1,0.9100775193798449,0.08992248062015504,1175,0.08139534883720931,0.007751937984496124,0.9108527131782945
1099,Baltimore City,2558,Baltimore City Precinct 13-001,1793,199,7,765,2558,1,0.700938232994527,0.29906176700547304,2352,0.07779515246286162,0.002736512900703675,0.9194683346364347
1100,Baltimore City,1628,Baltimore City Precinct 27-047,1104,81,6,524,1628,1,0.6781326781326781,0.32186732186732187,1541,0.049754299754299756,0.0036855036855036856,0.9465601965601965
1101,Baltimore City,1385,Baltimore City Precinct 13-002,1103,112,8,282,1385,1,0.7963898916967509,0.2036101083032491,1265,0.08086642599277978,0.005776173285198556,0.9133574007220217
1102,Baltimore City,802,Baltimore City Precinct 27-046,669,121,7,133,802,1,0.8341645885286783,0.1658354114713217,674,0.15087281795511223,0.008728179551122194,0.8403990024937655
1103,Baltimore City,4732,Baltimore City Precinct 27-045,3995,194,13,737,4732,1,0.8442519019442096,0.15574809805579037,4525,0.040997464074387154,0.0027472527472527475,0.9562552831783601
1104,Baltimore City,1486,Baltimore City Precinct 12-003,862,48,5,624,1486,1,0.5800807537012113,0.4199192462987887,1433,0.03230148048452221,0.0033647375504710633,0.9643337819650067
1105,Baltimore City,1587,Baltimore City Precinct 12-006,1031,72,4,556,1587,1,0.649653434152489,0.350346565847511,1511,0.045368620037807186,0.002520478890989288,0.9521109010712036
1106,Baltimore City,1914,Baltimore City Precinct 12-005,1218,96,8,696,1914,1,0.6363636363636364,0.36363636363636365,1810,0.050156739811912224,0.0041797283176593526,0.9456635318704284
1107,Baltimore City,3814,Baltimore City Precinct 12-004,2068,104,14,1746,3814,1,0.5422128998426848,0.45778710015731516,3696,0.027267960146827478,0.0036706869428421605,0.9690613529103304
1108,Baltimore City,2306,Baltimore City Precinct 12-002,1529,24,2,777,2306,1,0.663052905464007,0.3369470945359931,2280,0.010407632263660017,0.0008673026886383347,0.9887250650477016
1109,Baltimore City,2090,Baltimore City Precinct 12-001,1535,429,24,555,2090,1,0.7344497607655502,0.26555023923444976,1637,0.20526315789473684,0.011483253588516746,0.7832535885167464
1163,Baltimore City,2988,Baltimore City Precinct 28-006,115,241,111,2873,2988,1,0.03848728246318608,0.9615127175368139,2636,0.08065595716198126,0.03714859437751004,0.8821954484605087
1164,Baltimore City,1374,Baltimore City Precinct 28-007,38,113,64,1336,1374,1,0.027656477438136828,0.9723435225618632,1197,0.08224163027656478,0.046579330422125184,0.87117903930131
1165,Baltimore City,1808,Baltimore City Precinct 28-005,29,163,66,1779,1808,1,0.016039823008849558,0.9839601769911505,1579,0.09015486725663717,0.03650442477876106,0.8733407079646017
1166,Baltimore City,2470,Baltimore City Precinct 28-002,50,264,77,2420,2470,1,0.020242914979757085,0.979757085020243,2129,0.10688259109311742,0.031174089068825912,0.8619433198380567
1167,Baltimore City,882,Baltimore City Precinct 28-004,11,69,37,871,882,1,0.012471655328798186,0.9875283446712018,776,0.0782312925170068,0.04195011337868481,0.8798185941043084
1168,Baltimore City,1074,Baltimore City Precinct 15-002,22,109,22,1052,1074,1,0.020484171322160148,0.9795158286778398,943,0.10148975791433892,0.020484171322160148,0.8780260707635009
1169,Baltimore City,2856,Baltimore City Precinct 15-009,38,212,80,2818,2856,1,0.01330532212885154,0.9866946778711485,2564,0.0742296918767507,0.028011204481792718,0.8977591036414566
1201,Baltimore City,1822,Baltimore City Precinct 03-001,235,97,15,1587,1822,1,0.12897914379802414,0.8710208562019759,1710,0.05323819978046103,0.00823271130625686,0.9385290889132821
1202,Baltimore City,356,Baltimore City Precinct 05-002,41,31,1,315,356,1,0.1151685393258427,0.8848314606741573,324,0.08707865168539326,0.0028089887640449437,0.9101123595505618
1203,Baltimore City,1273,Baltimore City Precinct 10-002,8,135,23,1265,1273,1,0.006284367635506678,0.9937156323644933,1115,0.10604870384917518,0.018067556952081697,0.8758837391987431
1204,Baltimore City,987,Baltimore City Precinct 10-001,13,104,14,974,987,1,0.013171225937183385,0.9868287740628167,869,0.10536980749746708,0.014184397163120567,0.8804457953394124
1205,Baltimore City,1789,Baltimore City Precinct 09-015,22,129,54,1767,1789,1,0.012297372833985467,0.9877026271660145,1606,0.07210732252655115,0.03018446059250978,0.897708216880939
1206,Baltimore City,1316,Baltimore City Precinct 12-007,363,105,26,953,1316,1,0.27583586626139817,0.7241641337386018,1185,0.0797872340425532,0.019756838905775075,0.9004559270516718
1207,Baltimore City,1357,Baltimore City Precinct 09-014,18,114,14,1339,1357,1,0.013264554163596167,0.9867354458364038,1229,0.08400884303610906,0.010316875460574797,0.9056742815033162
1208,Baltimore City,364,Baltimore City Precinct 09-011,6,15,0,358,364,1,0.016483516483516484,0.9835164835164835,349,0.04120879120879121,0.0,0.9587912087912088
1209,Baltimore City,917,Baltimore City Precinct 09-013,12,75,8,905,917,1,0.013086150490730643,0.9869138495092693,834,0.08178844056706652,0.008724100327153763,0.9094874591057798
1210,Baltimore City,1609,Baltimore City Precinct 09-012,36,121,22,1573,1609,1,0.022374145431945307,0.9776258545680547,1466,0.07520198881292728,0.013673088875077687,0.911124922311995
1211,Baltimore City,1368,Baltimore City Precinct 02-001,706,57,9,662,1368,1,0.5160818713450293,0.48391812865497075,1302,0.041666666666666664,0.006578947368421052,0.9517543859649122
1212,Baltimore City,1117,Baltimore City Precinct 06-004,528,93,10,589,1117,1,0.4726947179946285,0.5273052820053715,1014,0.08325872873769025,0.008952551477170993,0.9077887197851388
1213,Baltimore City,475,Baltimore City Precinct 06-003,44,37,12,431,475,1,0.09263157894736843,0.9073684210526316,426,0.07789473684210527,0.02526315789473684,0.8968421052631579
1214,Baltimore City,1050,Baltimore City Precinct 07-001,14,67,11,1036,1050,1,0.013333333333333334,0.9866666666666667,972,0.06380952380952382,0.010476190476190476,0.9257142857142857
1215,Baltimore City,441,Baltimore City Precinct 08-007,11,43,12,430,441,1,0.024943310657596373,0.9750566893424036,386,0.09750566893424037,0.027210884353741496,0.8752834467120182
1216,Baltimore City,250,Baltimore City Precinct 07-002,11,14,2,239,250,1,0.044,0.956,234,0.056,0.008,0.936
1217,Baltimore City,819,Baltimore City Precinct 06-002,107,29,4,712,819,1,0.13064713064713065,0.8693528693528694,786,0.03540903540903541,0.004884004884004884,0.9597069597069597
1218,Baltimore City,2445,Baltimore City Precinct 07-003,84,120,28,2361,2445,1,0.0343558282208589,0.9656441717791411,2297,0.049079754601226995,0.011451942740286299,0.9394683026584867
1219,Baltimore City,986,Baltimore City Precinct 08-008,30,60,9,956,986,1,0.030425963488843813,0.9695740365111561,917,0.060851926977687626,0.009127789046653144,0.9300202839756593
1220,Baltimore City,1928,Baltimore City Precinct 08-006,31,129,78,1897,1928,1,0.016078838174273857,0.9839211618257261,1721,0.06690871369294606,0.04045643153526971,0.8926348547717843
1221,Baltimore City,1774,Baltimore City Precinct 08-005,22,108,56,1752,1774,1,0.012401352874859075,0.9875986471251409,1610,0.060879368658399095,0.03156708004509583,0.9075535512965051
1222,Baltimore City,1071,Baltimore City Precinct 08-009,21,50,7,1050,1071,1,0.0196078431372549,0.9803921568627451,1014,0.04668534080298786,0.006535947712418301,0.9467787114845938
1223,Baltimore City,473,Baltimore City Precinct 08-004,8,36,10,465,473,1,0.016913319238900635,0.9830866807610994,427,0.07610993657505286,0.021141649048625793,0.9027484143763214
1224,Baltimore City,951,Baltimore City Precinct 26-008,818,40,6,133,951,1,0.8601472134595163,0.1398527865404837,905,0.04206098843322818,0.006309148264984227,0.9516298633017876
1225,Baltimore City,2859,Baltimore City Precinct 01-004,2482,96,10,377,2859,1,0.8681357117873383,0.13186428821266177,2753,0.033578174186778595,0.003497726477789437,0.962924099335432
1226,Baltimore City,3180,Baltimore City Precinct 01-005,2843,123,13,337,3180,1,0.8940251572327044,0.1059748427672956,3044,0.038679245283018866,0.004088050314465409,0.9572327044025157
1227,Baltimore City,3113,Baltimore City Precinct 26-009,2667,122,15,446,3113,1,0.856729842595567,0.14327015740443302,2976,0.039190491487311276,0.004818503051718599,0.9559910054609702
1228,Baltimore City,1478,Baltimore City Precinct 26-006,963,38,1,515,1478,1,0.6515561569688768,0.34844384303112313,1439,0.02571041948579161,0.0006765899864682003,0.9736129905277402
1229,Baltimore City,1558,Baltimore City Precinct 01-001,1017,64,7,541,1558,1,0.6527599486521181,0.3472400513478819,1487,0.0410783055198973,0.004492939666238768,0.9544287548138639
1230,Baltimore City,3120,Baltimore City Precinct 06-005,1381,104,34,1739,3120,1,0.4426282051282051,0.5573717948717949,2982,0.03333333333333333,0.010897435897435897,0.9557692307692308
1231,Baltimore City,1744,Baltimore City Precinct 06-001,198,59,23,1546,1744,1,0.11353211009174312,0.8864678899082569,1662,0.0338302752293578,0.013188073394495414,0.9529816513761468
1232,Baltimore City,1555,Baltimore City Precinct 23-001,1384,64,4,171,1555,1,0.890032154340836,0.10996784565916398,1487,0.041157556270096464,0.002572347266881029,0.9562700964630225
1233,Baltimore City,1449,Baltimore City Precinct 22-002,1253,136,9,196,1449,1,0.8647342995169082,0.13526570048309178,1304,0.09385783298826778,0.006211180124223602,0.8999309868875086
1234,Baltimore City,1095,Baltimore City Precinct 22-001,797,140,12,298,1095,1,0.7278538812785388,0.27214611872146116,943,0.1278538812785388,0.010958904109589041,0.8611872146118722
1235,Baltimore City,1382,Baltimore City Precinct 19-001,24,79,44,1358,1382,1,0.017366136034732273,0.9826338639652678,1259,0.057163531114327065,0.03183791606367583,0.9109985528219972
1236,Baltimore City,1137,Baltimore City Precinct 16-003,9,58,21,1128,1137,1,0.0079155672823219,0.9920844327176781,1058,0.051011433597185574,0.018469656992084433,0.93051890941073
1237,Baltimore City,1737,Baltimore City Precinct 16-002,27,89,41,1710,1737,1,0.015544041450777202,0.9844559585492227,1607,0.051237766263673,0.02360391479562464,0.9251583189407023
1238,Baltimore City,985,Baltimore City Precinct 16-001,18,55,19,967,985,1,0.018274111675126905,0.9817258883248731,911,0.05583756345177665,0.019289340101522844,0.9248730964467005
1239,Baltimore City,1226,Baltimore City Precinct 18-001,14,63,20,1212,1226,1,0.011419249592169658,0.9885807504078303,1143,0.05138662316476346,0.01631321370309951,0.932300163132137
1240,Baltimore City,1367,Baltimore City Precinct 17-002,16,118,20,1351,1367,1,0.011704462326261888,0.9882955376737381,1229,0.08632040965618142,0.014630577907827359,0.8990490124359912
1241,Baltimore City,1008,Baltimore City Precinct 14-003,24,49,29,984,1008,1,0.023809523809523808,0.9761904761904762,930,0.04861111111111111,0.028769841269841268,0.9226190476190477
1242,Baltimore City,1794,Baltimore City Precinct 15-019,31,87,46,1763,1794,1,0.017279821627647716,0.9827201783723523,1661,0.048494983277591976,0.02564102564102564,0.9258639910813824
1243,Baltimore City,529,Baltimore City Precinct 14-005,4,41,4,525,529,1,0.007561436672967864,0.9924385633270322,484,0.07750472589792061,0.007561436672967864,0.9149338374291115
1244,Baltimore City,1897,Baltimore City Precinct 13-008,110,172,48,1787,1897,1,0.05798629414865577,0.9420137058513443,1677,0.09066947812335266,0.025303110173958882,0.8840274117026885
1245,Baltimore City,1483,Baltimore City Precinct 13-007,15,102,54,1468,1483,1,0.010114632501685773,0.9898853674983142,1327,0.06877950101146325,0.03641267700606878,0.894807821982468
1246,Baltimore City,2314,Baltimore City Precinct 14-004,223,174,51,2091,2314,1,0.09636992221261884,0.9036300777873811,2089,0.07519446845289542,0.022039757994814176,0.9027657735522904
1247,Baltimore City,1277,Baltimore City Precinct 13-009,88,107,24,1189,1277,1,0.06891151135473766,0.9310884886452623,1146,0.08379013312451057,0.018794048551292093,0.8974158183241974
1248,Baltimore City,1887,Baltimore City Precinct 13-010,272,150,40,1615,1887,1,0.14414414414414414,0.8558558558558559,1697,0.0794912559618442,0.021197668256491786,0.899311075781664
1249,Baltimore City,588,Baltimore City Precinct 04-003,33,46,21,555,588,1,0.05612244897959184,0.9438775510204082,521,0.0782312925170068,0.03571428571428571,0.8860544217687075
1250,Baltimore City,2521,Baltimore City Precinct 04-002,1231,71,15,1290,2521,1,0.48829829432764776,0.5117017056723523,2435,0.02816342721142404,0.005950019833399445,0.9658865529551766
1251,Baltimore City,1979,Baltimore City Precinct 17-001,162,88,44,1817,1979,1,0.08185952501263265,0.9181404749873674,1847,0.04446690247599798,0.02223345123799899,0.933299646286003
1252,Baltimore City,1028,Baltimore City Precinct 11-004,115,42,29,913,1028,1,0.11186770428015565,0.8881322957198443,957,0.04085603112840467,0.02821011673151751,0.9309338521400778
1253,Baltimore City,1704,Baltimore City Precinct 11-003,892,170,18,812,1704,1,0.5234741784037559,0.4765258215962441,1516,0.09976525821596244,0.01056338028169014,0.8896713615023474
1254,Baltimore City,2097,Baltimore City Precinct 04-001,924,59,7,1173,2097,1,0.4406294706723891,0.5593705293276109,2031,0.028135431568907965,0.0033381020505484026,0.9685264663805436
1255,Baltimore City,2967,Baltimore City Precinct 11-006,1600,162,21,1367,2967,1,0.5392652510953826,0.46073474890461746,2784,0.054600606673407485,0.007077856420626896,0.9383215369059656
1256,Baltimore City,870,Baltimore City Precinct 11-005,547,51,7,323,870,1,0.628735632183908,0.37126436781609196,812,0.05862068965517241,0.008045977011494253,0.9333333333333333
1257,Baltimore City,645,Baltimore City Precinct 11-002,302,55,10,343,645,1,0.4682170542635659,0.5317829457364341,580,0.08527131782945736,0.015503875968992248,0.8992248062015504
1258,Baltimore City,1818,Baltimore City Precinct 11-007,1109,109,16,709,1818,1,0.61001100110011,0.38998899889988997,1693,0.059955995599559955,0.0088008800880088,0.9312431243124313
1259,Baltimore City,1899,Baltimore City Precinct 11-001,1177,96,17,722,1899,1,0.6197998946814113,0.3802001053185887,1786,0.05055292259083728,0.008952080042127435,0.9404949973670352
1260,Baltimore City,1670,Baltimore City Precinct 14-002,830,128,22,840,1670,1,0.49700598802395207,0.5029940119760479,1520,0.07664670658682635,0.013173652694610778,0.9101796407185628
1261,Baltimore City,1524,Baltimore City Precinct 14-001,930,99,11,594,1524,1,0.610236220472441,0.38976377952755903,1414,0.06496062992125984,0.007217847769028871,0.9278215223097113
1262,Baltimore City,2304,Baltimore City Precinct 12-009,1078,106,19,1226,2304,1,0.4678819444444444,0.5321180555555556,2179,0.04600694444444445,0.008246527777777778,0.9457465277777778
1263,Baltimore City,1485,Baltimore City Precinct 12-012,447,73,17,1038,1485,1,0.301010101010101,0.6989898989898989,1395,0.04915824915824916,0.011447811447811448,0.9393939393939394
1289,Baltimore City,1691,Baltimore City Precinct 16-009,6,128,35,1685,1691,1,0.0035481963335304554,0.9964518036664696,1528,0.07569485511531639,0.02069781194559432,0.9036073329390893
1290,Baltimore City,1025,Baltimore City Precinct 16-010,10,67,10,1015,1025,1,0.00975609756097561,0.9902439024390244,948,0.06536585365853659,0.00975609756097561,0.9248780487804878
1291,Baltimore City,936,Baltimore City Precinct 16-011,6,49,24,930,936,1,0.00641025641025641,0.9935897435897436,863,0.05235042735042735,0.02564102564102564,0.9220085470085471
1292,Baltimore City,365,Baltimore City Precinct 15-012,13,22,10,352,365,1,0.03561643835616438,0.9643835616438357,333,0.06027397260273973,0.0273972602739726,0.9123287671232877
1293,Baltimore City,1645,Baltimore City Precinct 15-007,21,120,38,1624,1645,1,0.01276595744680851,0.9872340425531915,1487,0.0729483282674772,0.023100303951367782,0.903951367781155
1294,Baltimore City,754,Baltimore City Precinct 15-013,5,53,17,749,754,1,0.006631299734748011,0.993368700265252,684,0.07029177718832891,0.022546419098143235,0.9071618037135278
1295,Baltimore City,813,Baltimore City Precinct 15-015,5,50,10,808,813,1,0.006150061500615006,0.993849938499385,753,0.06150061500615006,0.012300123001230012,0.9261992619926199
1296,Baltimore City,1295,Baltimore City Precinct 15-014,10,133,50,1285,1295,1,0.007722007722007722,0.9922779922779923,1112,0.10270270270270271,0.03861003861003861,0.8586872586872587
1297,Baltimore City,1699,Baltimore City Precinct 15-006,17,190,67,1682,1699,1,0.010005885815185403,0.9899941141848146,1442,0.11183048852266039,0.0394349617422013,0.8487345497351383
1298,Baltimore City,964,Baltimore City Precinct 16-007,6,114,35,958,964,1,0.006224066390041493,0.9937759336099585,815,0.11825726141078838,0.03630705394190872,0.8454356846473029
1299,Baltimore City,1884,Baltimore City Precinct 16-006,7,147,38,1877,1884,1,0.0037154989384288748,0.9962845010615711,1699,0.07802547770700637,0.020169851380042462,0.9018046709129511
1300,Baltimore City,1791,Baltimore City Precinct 20-001,30,112,53,1761,1791,1,0.01675041876046901,0.983249581239531,1626,0.06253489670575098,0.02959240647682859,0.9078726968174204
1301,Baltimore City,764,Baltimore City Precinct 16-004,12,34,17,752,764,1,0.015706806282722512,0.9842931937172775,713,0.04450261780104712,0.02225130890052356,0.9332460732984293
1302,Baltimore City,2126,Baltimore City Precinct 16-005,27,117,36,2099,2126,1,0.012699905926622766,0.9873000940733773,1973,0.05503292568203198,0.016933207902163686,0.9280338664158043
1303,Baltimore City,1404,Baltimore City Precinct 15-018,4,77,22,1400,1404,1,0.002849002849002849,0.9971509971509972,1305,0.054843304843304845,0.01566951566951567,0.9294871794871795
1304,Baltimore City,1040,Baltimore City Precinct 15-016,9,64,17,1031,1040,1,0.008653846153846154,0.9913461538461539,959,0.06153846153846154,0.016346153846153847,0.9221153846153847
1305,Baltimore City,2987,Baltimore City Precinct 15-020,37,200,45,2950,2987,1,0.012387010378305993,0.987612989621694,2742,0.06695681285570806,0.015065282892534315,0.9179779042517576
1306,Baltimore City,1237,Baltimore City Precinct 15-021,14,115,27,1223,1237,1,0.01131770412287793,0.9886822958771221,1095,0.09296685529506872,0.021827000808407437,0.8852061438965239
1307,Baltimore City,1807,Baltimore City Precinct 15-017,23,126,55,1784,1807,1,0.012728278915329275,0.9872717210846708,1626,0.06972883231876037,0.030437188710570006,0.8998339789706696
1308,Baltimore City,1062,Baltimore City Precinct 25-006,24,81,19,1038,1062,1,0.022598870056497175,0.9774011299435028,962,0.07627118644067797,0.017890772128060263,0.9058380414312618
1309,Baltimore City,596,Baltimore City Precinct 25-007,133,18,7,463,596,1,0.2231543624161074,0.7768456375838926,571,0.030201342281879196,0.01174496644295302,0.9580536912751678
1310,Baltimore City,2234,Baltimore City Precinct 21-003,992,106,12,1242,2234,1,0.4440465532676813,0.5559534467323187,2116,0.047448522829006266,0.005371530886302597,0.9471799462846912
1311,Baltimore City,3343,Baltimore City Precinct 19-002,1090,92,25,2253,3343,1,0.3260544421178582,0.6739455578821418,3226,0.02752019144481005,0.007478312892611427,0.9650014956625785
1312,Baltimore City,489,Baltimore City Precinct 21-004,246,32,5,243,489,1,0.5030674846625767,0.49693251533742333,452,0.065439672801636,0.010224948875255624,0.9243353783231084
1313,Baltimore City,1952,Baltimore City Precinct 18-002,558,88,12,1394,1952,1,0.2858606557377049,0.7141393442622951,1852,0.045081967213114756,0.006147540983606557,0.9487704918032787
1314,Baltimore City,1673,Baltimore City Precinct 21-002,672,101,31,1001,1673,1,0.401673640167364,0.5983263598326359,1541,0.06037059175134489,0.01852958756724447,0.9210998206814106
1315,Baltimore City,2033,Baltimore City Precinct 23-003,1802,65,7,231,2033,1,0.8863748155435317,0.11362518445646827,1961,0.031972454500737824,0.003443187407771766,0.9645843580914905
1316,Baltimore City,1153,Baltimore City Precinct 21-001,755,60,6,398,1153,1,0.6548135299219427,0.34518647007805725,1087,0.05203816131830009,0.005203816131830009,0.94275802254987
1317,Baltimore City,1038,Baltimore City Precinct 23-002,584,62,6,454,1038,1,0.5626204238921002,0.4373795761078998,970,0.05973025048169557,0.005780346820809248,0.9344894026974951
1318,Baltimore City,2506,Baltimore City Precinct 20-007,148,174,63,2358,2506,1,0.05905826017557861,0.9409417398244214,2269,0.06943335993615324,0.025139664804469275,0.9054269752593775
1319,Baltimore City,2106,Baltimore City Precinct 28-010,255,204,57,1851,2106,1,0.12108262108262108,0.8789173789173789,1845,0.09686609686609686,0.027065527065527065,0.8760683760683761
1320,Baltimore City,458,Baltimore City Precinct 28-012,55,70,16,403,458,1,0.12008733624454149,0.8799126637554585,372,0.15283842794759825,0.034934497816593885,0.8122270742358079
1321,Baltimore City,2423,Baltimore City Precinct 28-009,274,161,43,2149,2423,1,0.1130829550144449,0.8869170449855551,2219,0.06644655385885266,0.017746595130004126,0.9158068510111432
1322,Baltimore City,1962,Baltimore City Precinct 28-011,173,219,70,1789,1962,1,0.08817533129459736,0.9118246687054027,1673,0.11162079510703364,0.03567787971457696,0.8527013251783894
1323,Baltimore City,3079,Baltimore City Precinct 20-006,15,229,106,3064,3079,1,0.004871711594673595,0.9951282884053264,2744,0.0743747970120169,0.034426761935693405,0.8911984410522897
1324,Baltimore City,3001,Baltimore City Precinct 16-014,29,299,84,2972,3001,1,0.009663445518160613,0.9903365544818394,2618,0.09963345551482838,0.027990669776741087,0.8723758747084305
1325,Baltimore City,1740,Baltimore City Precinct 28-008,83,146,46,1657,1740,1,0.04770114942528736,0.9522988505747126,1548,0.0839080459770115,0.026436781609195402,0.8896551724137931
1326,Baltimore City,1451,Baltimore City Precinct 15-011,43,104,41,1408,1451,1,0.029634734665747762,0.9703652653342523,1306,0.07167470709855273,0.028256374913852515,0.9000689179875948
1327,Baltimore City,1492,Baltimore City Precinct 15-010,39,142,86,1453,1492,1,0.02613941018766756,0.9738605898123325,1264,0.09517426273458444,0.057640750670241284,0.8471849865951743
1375,Baltimore City,2932,Baltimore City Precinct 28-015,976,211,42,1956,2932,1,0.3328785811732606,0.6671214188267395,2679,0.07196452933151433,0.01432469304229195,0.9137107776261937
1376,Baltimore City,2794,Baltimore City Precinct 25-001,329,209,89,2465,2794,1,0.11775232641374374,0.8822476735862562,2496,0.07480314960629922,0.03185397279885469,0.8933428775948461
1377,Baltimore City,742,Baltimore City Precinct 28-014,55,52,21,687,742,1,0.07412398921832884,0.9258760107816711,669,0.07008086253369272,0.02830188679245283,0.9016172506738545
1378,Baltimore City,2138,Baltimore City Precinct 25-002,205,122,68,1933,2138,1,0.09588400374181479,0.9041159962581852,1948,0.05706267539756782,0.031805425631431246,0.9111318989710009
1379,Baltimore City,1494,Baltimore City Precinct 28-013,105,98,54,1389,1494,1,0.07028112449799197,0.929718875502008,1342,0.06559571619812583,0.03614457831325301,0.8982597054886211
1380,Baltimore City,714,Baltimore City Precinct 20-008,104,32,9,610,714,1,0.14565826330532214,0.8543417366946778,673,0.04481792717086835,0.012605042016806723,0.9425770308123249
1698,Baltimore City,1766,Baltimore City Precinct 15-001,42,132,73,1724,1766,1,0.02378255945639864,0.9762174405436014,1561,0.07474518686296716,0.041336353340883356,0.8839184597961495
1699,Baltimore City,571,Baltimore City Precinct 28-003,5,40,16,566,571,1,0.008756567425569177,0.9912434325744308,515,0.07005253940455342,0.028021015761821366,0.9019264448336253
1700,Baltimore City,1228,Baltimore City Precinct 27-061,324,59,13,904,1228,1,0.26384364820846906,0.7361563517915309,1156,0.04804560260586319,0.010586319218241042,0.9413680781758957
1701,Baltimore City,1238,Baltimore City Precinct 27-056,13,78,20,1225,1238,1,0.01050080775444265,0.9894991922455574,1140,0.0630048465266559,0.01615508885298869,0.9208400646203554
1702,Baltimore City,2460,Baltimore City Precinct 27-057,36,162,44,2424,2460,1,0.014634146341463415,0.9853658536585366,2254,0.06585365853658537,0.01788617886178862,0.916260162601626
1703,Baltimore City,1163,Baltimore City Precinct 27-059,32,72,22,1131,1163,1,0.027515047291487533,0.9724849527085124,1069,0.061908856405846945,0.018916595012897677,0.9191745485812554
1704,Baltimore City,1669,Baltimore City Precinct 28-001,105,107,50,1564,1669,1,0.06291192330736968,0.9370880766926303,1512,0.06411024565608149,0.029958058717795086,0.9059316956261234
1705,Baltimore City,3062,Baltimore City Precinct 27-067,1028,163,48,2034,3062,1,0.3357282821685173,0.6642717178314826,2851,0.05323318092749837,0.015676028739386023,0.9310907903331156
1706,Baltimore City,2688,Baltimore City Precinct 27-062,1151,135,31,1537,2688,1,0.42819940476190477,0.5718005952380952,2522,0.05022321428571429,0.011532738095238096,0.9382440476190477
1707,Baltimore City,2392,Baltimore City Precinct 27-066,1756,202,17,636,2392,1,0.7341137123745819,0.26588628762541805,2173,0.08444816053511706,0.007107023411371237,0.9084448160535117
1709,Baltimore City,1675,Baltimore City Precinct 27-063,770,152,36,905,1675,1,0.4597014925373134,0.5402985074626866,1487,0.09074626865671642,0.021492537313432834,0.8877611940298508
1710,Baltimore City,3698,Baltimore City Precinct 27-065,2866,287,22,832,3698,1,0.775013520822066,0.22498647917793402,3389,0.07760951865873444,0.005949161709031909,0.9164413196322336
1711,Baltimore City,997,Baltimore City Precinct 27-060,171,137,44,826,997,1,0.1715145436308927,0.8284854563691073,816,0.1374122367101304,0.044132397191574725,0.8184553660982948
1712,Baltimore City,1689,Baltimore City Precinct 27-064,1206,165,13,483,1689,1,0.7140319715808171,0.28596802841918295,1511,0.09769094138543517,0.0076968620485494375,0.8946121965660154
1726,Baltimore City,818,Baltimore City Precinct 15-008,13,113,48,805,818,1,0.01589242053789731,0.9841075794621027,657,0.13814180929095354,0.05867970660146699,0.8031784841075794
1727,Baltimore City,2394,Baltimore City Precinct 15-003,33,245,93,2361,2394,1,0.013784461152882205,0.9862155388471178,2056,0.1023391812865497,0.03884711779448621,0.858813700918964
1728,Baltimore City,1024,Baltimore City Precinct 15-004,8,70,27,1016,1024,1,0.0078125,0.9921875,927,0.068359375,0.0263671875,0.9052734375
1729,Baltimore City,1372,Baltimore City Precinct 15-005,11,158,74,1361,1372,1,0.008017492711370262,0.9919825072886297,1140,0.1151603498542274,0.05393586005830904,0.8309037900874635
