,County,VAP,BVAP,EL12G_PR_D,EL12G_PR_R,OVAP,TOT_VOTES,factor,BVAP_pct,OVAP_pct,PRES12None,EL12G_PR_D_pct,EL12G_PR_R_pct,PRES12None_pct
0,37001,1505,338,351,324,1167,1505,1.0,0.2245847176079734,0.7754152823920266,830,0.23322259136212625,0.21528239202657806,0.5514950166112956
1,37001,2503,712,594,344,1791,2503,1.0,0.2844586496204555,0.7155413503795446,1565,0.2373152217339193,0.1374350779065122,0.6252497003595685
2,37001,2156,243,650,736,1913,2156,1.0,0.11270871985157699,0.887291280148423,770,0.3014842300556586,0.34137291280148424,0.35714285714285715
3,37001,3167,1027,941,432,2140,3167,1.0,0.3242816545626776,0.6757183454373223,1794,0.29712661825071046,0.13640669403220715,0.5664666877170824
4,37001,1713,50,476,965,1663,1713,1.0,0.02918855808523059,0.9708114419147694,272,0.2778750729713952,0.5633391710449503,0.1587857559836544
5,37001,1948,276,543,723,1672,1948,1.0,0.14168377823408623,0.8583162217659137,682,0.27874743326488705,0.3711498973305955,0.35010266940451745
6,37001,2127,494,550,549,1633,2127,1.0,0.23225199811941702,0.767748001880583,1028,0.25858015984955335,0.25811001410437234,0.4833098260460743
7,37001,4955,350,1143,1618,4605,4955,1.0,0.07063572149344097,0.929364278506559,2194,0.2306760847628658,0.3265388496468214,0.44278506559031283
8,37001,3483,81,429,1936,3402,3483,1.0,0.023255813953488372,0.9767441860465116,1118,0.1231696813092162,0.5558426643697961,0.32098765432098764
9,37001,2371,578,753,683,1793,2371,1.0,0.24377899620413326,0.7562210037958668,935,0.31758751581611133,0.2880641079713201,0.3943483762125685
10,37001,3130,469,667,1147,2661,3130,1.0,0.14984025559105432,0.8501597444089457,1316,0.21309904153354634,0.3664536741214057,0.4204472843450479
11,37001,3498,1037,987,570,2461,3498,1.0,0.2964551172098342,0.7035448827901658,1941,0.28216123499142365,0.16295025728987994,0.5548885077186964
12,37001,4530,2457,2009,275,2073,4530,1.0,0.5423841059602649,0.45761589403973507,2246,0.4434878587196468,0.06070640176600441,0.4958057395143488
13,37001,3686,257,488,1661,3429,3686,1.0,0.06972327726532827,0.9302767227346718,1537,0.13239283776451438,0.45062398263700487,0.41698317959848075
14,37001,2197,201,483,899,1996,2197,1.0,0.09148839326354119,0.9085116067364588,815,0.21984524351388257,0.4091943559399181,0.3709604005461994
15,37001,1630,141,339,755,1489,1630,1.0,0.08650306748466258,0.9134969325153375,536,0.20797546012269938,0.46319018404907975,0.32883435582822085
16,37001,5580,729,1380,2088,4851,5580,1.0,0.13064516129032258,0.8693548387096774,2112,0.24731182795698925,0.3741935483870968,0.37849462365591396
17,37001,1694,70,283,685,1624,1694,1.0,0.04132231404958678,0.9586776859504132,726,0.16706021251475797,0.40436835891381345,0.42857142857142855
18,37001,3476,1342,1280,880,2134,3476,1.0,0.3860759493670886,0.6139240506329114,1316,0.36823935558112775,0.25316455696202533,0.378596087456847
19,37001,5931,1310,2098,2045,4621,5931,1.0,0.2208733771707975,0.7791266228292025,1788,0.3537346147361322,0.34479851627044344,0.3014668689934244
20,37001,3118,255,643,1117,2863,3118,1.0,0.081783194355356,0.918216805644644,1358,0.2062219371391918,0.35824246311738295,0.43553559974342526
21,37001,4345,476,924,1731,3869,4345,1.0,0.1095512082853855,0.8904487917146146,1690,0.21265822784810126,0.39838895281933256,0.38895281933256615
22,37001,2757,951,794,336,1806,2757,1.0,0.34494015233949943,0.6550598476605005,1627,0.2879941965904969,0.12187159956474429,0.5901342038447588
23,37001,2408,198,568,1125,2210,2408,1.0,0.08222591362126246,0.9177740863787376,715,0.23588039867109634,0.46719269102990035,0.2969269102990033
24,37001,3146,267,559,1195,2879,3146,1.0,0.08486967577876668,0.9151303242212333,1392,0.17768595041322313,0.37984742530197074,0.4424666242848061
25,37001,4661,519,1078,1666,4142,4661,1.0,0.11134949581634843,0.8886505041836515,1917,0.23128084102124008,0.35743402703282556,0.41128513194593436
26,37001,3292,503,950,1459,2789,3292,1.0,0.15279465370595383,0.8472053462940462,883,0.2885783718104496,0.4431956257594168,0.26822600243013367
27,37001,3307,149,425,1593,3158,3307,1.0,0.04505594194133656,0.9549440580586634,1289,0.12851527063804052,0.4817054732385848,0.38977925612337466
28,37001,1860,602,534,215,1258,1860,1.0,0.32365591397849464,0.6763440860215054,1111,0.2870967741935484,0.11559139784946236,0.5973118279569892
29,37001,2681,152,365,1358,2529,2681,1.0,0.0566952629615815,0.9433047370384186,958,0.1361432301380082,0.5065274151436031,0.35732935471838867
30,37001,4070,1178,1145,995,2892,4070,1.0,0.28943488943488943,0.7105651105651105,1930,0.28132678132678135,0.24447174447174447,0.4742014742014742
31,37001,5660,421,832,1437,5239,5660,1.0,0.07438162544169612,0.9256183745583039,3391,0.1469964664310954,0.253886925795053,0.5991166077738516
32,37001,4194,420,627,1951,3774,4194,1.0,0.10014306151645208,0.899856938483548,1616,0.14949928469241774,0.4651883643299952,0.38531235097758704
33,37001,2153,148,526,1318,2005,2153,1.0,0.06874129122155133,0.9312587087784486,309,0.24431026474686485,0.6121690664189503,0.14352066883418485
34,37001,1834,329,479,763,1505,1834,1.0,0.17938931297709923,0.8206106870229007,592,0.2611777535441658,0.41603053435114506,0.3227917121046892
35,37001,4922,2325,1982,596,2597,4922,1.0,0.47236895570906134,0.5276310442909387,2344,0.4026818366517676,0.12108898821617228,0.47622917513206015
36,37003,2871,14,455,1596,2857,2871,1.0,0.004876349703935911,0.9951236502960641,820,0.1584813653779171,0.5559038662486938,0.28561476837338906
37,37003,3528,24,548,1699,3504,3528,1.0,0.006802721088435374,0.9931972789115646,1281,0.15532879818594103,0.4815759637188209,0.3630952380952381
38,37003,2567,121,463,1161,2446,2567,1.0,0.047136735488897546,0.9528632645111025,943,0.18036618620958317,0.45227892481495907,0.3673548889754577
39,37003,769,5,98,389,764,769,1.0,0.006501950585175552,0.9934980494148244,282,0.12743823146944083,0.505851755526658,0.36671001300390116
40,37003,940,39,184,419,901,940,1.0,0.04148936170212766,0.9585106382978723,337,0.19574468085106383,0.44574468085106383,0.35851063829787233
41,37003,1133,33,193,579,1100,1133,1.0,0.02912621359223301,0.970873786407767,361,0.1703442188879082,0.5110326566637247,0.31862312444836716
42,37003,1973,138,313,767,1835,1973,1.0,0.06994424733907754,0.9300557526609224,893,0.15864166244298022,0.38874809934110494,0.45261023821591484
43,37003,2417,67,325,936,2350,2417,1.0,0.02772031443938767,0.9722796855606123,1156,0.13446421183285065,0.38725693007860984,0.47827885808853954
44,37003,1019,61,199,403,958,1019,1.0,0.05986261040235525,0.9401373895976447,417,0.19528949950932287,0.39548577036310106,0.40922473012757604
45,37003,929,1,105,509,928,929,1.0,0.001076426264800861,0.9989235737351991,315,0.11302475780409042,0.5479009687836384,0.33907427341227125
46,37003,2802,569,223,690,2233,2802,1.0,0.2030692362598144,0.7969307637401856,1889,0.07958600999286224,0.2462526766595289,0.6741613133476089
47,37003,1758,246,397,610,1512,1758,1.0,0.13993174061433447,0.8600682593856656,751,0.22582480091012513,0.34698521046643915,0.4271899886234357
48,37003,1384,49,299,552,1335,1384,1.0,0.03540462427745665,0.9645953757225434,533,0.21604046242774566,0.3988439306358382,0.38511560693641617
49,37003,1737,230,389,591,1507,1737,1.0,0.13241220495106507,0.8675877950489349,757,0.22394933793897526,0.34024179620034545,0.43580886586067935
50,37003,1092,74,168,459,1018,1092,1.0,0.06776556776556776,0.9322344322344323,465,0.15384615384615385,0.42032967032967034,0.4258241758241758
51,37003,1826,10,252,893,1816,1826,1.0,0.00547645125958379,0.9945235487404163,681,0.1380065717415115,0.4890470974808324,0.3729463307776561
52,37005,702,0,123,281,702,702,1.0,0.0,1.0,298,0.1752136752136752,0.40028490028490027,0.42450142450142453
53,37005,718,5,145,248,713,718,1.0,0.006963788300835654,0.9930362116991643,325,0.201949860724234,0.34540389972144847,0.45264623955431754
54,37005,1214,3,224,572,1211,1214,1.0,0.002471169686985173,0.9975288303130149,418,0.18451400329489293,0.471169686985173,0.3443163097199341
55,37005,3532,71,712,1125,3461,3532,1.0,0.020101925254813136,0.9798980747451869,1695,0.2015855039637599,0.31851642129105323,0.47989807474518686
56,37005,1567,10,215,713,1557,1567,1.0,0.006381620931716656,0.9936183790682833,639,0.1372048500319081,0.45500957243139756,0.4077855775366943
57,37005,325,4,44,137,321,325,1.0,0.012307692307692308,0.9876923076923076,144,0.13538461538461538,0.42153846153846153,0.4430769230769231
58,37005,862,4,111,301,858,862,1.0,0.004640371229698376,0.9953596287703016,450,0.12877030162412992,0.3491879350348028,0.5220417633410673
59,37007,1595,217,257,581,1378,1595,1.0,0.1360501567398119,0.8639498432601881,757,0.16112852664576802,0.36426332288401253,0.4746081504702194
60,37007,353,117,100,95,236,353,1.0,0.3314447592067989,0.6685552407932012,158,0.28328611898017,0.26912181303116145,0.4475920679886686
61,37007,2672,1373,1142,518,1299,2672,1.0,0.5138473053892215,0.4861526946107784,1012,0.4273952095808383,0.19386227544910178,0.3787425149700599
62,37007,2623,1725,1314,399,898,2623,1.0,0.6576439191765154,0.34235608082348457,910,0.5009531071292413,0.15211589782691576,0.34693099504384295
63,37007,4109,2391,842,305,1718,4109,1.0,0.5818934047213434,0.4181065952786566,2962,0.20491603796544172,0.07422730591384766,0.7208566561207106
64,37007,2887,1149,973,626,1738,2887,1.0,0.3979909941115345,0.6020090058884655,1288,0.3370280568063734,0.2168340838240388,0.44613785936958783
65,37007,1431,937,789,151,494,1431,1.0,0.6547868623340322,0.34521313766596784,491,0.5513626834381551,0.10552061495457722,0.34311670160726765
66,37007,1513,237,281,596,1276,1513,1.0,0.1566424322538004,0.8433575677461996,636,0.18572372769332451,0.3939193654990086,0.4203569068076669
67,37007,1289,502,412,336,787,1289,1.0,0.3894491854150504,0.6105508145849495,541,0.31962761830876646,0.26066718386346005,0.4197051978277735
68,37007,1224,681,525,257,543,1224,1.0,0.5563725490196079,0.44362745098039214,442,0.42892156862745096,0.2099673202614379,0.3611111111111111
69,37007,1286,528,384,302,758,1286,1.0,0.4105754276827372,0.5894245723172629,600,0.2986003110419907,0.23483670295489892,0.4665629860031104
70,37009,930,3,142,372,927,930,1.0,0.0032258064516129032,0.9967741935483871,416,0.15268817204301074,0.4,0.44731182795698926
71,37009,710,2,126,296,708,710,1.0,0.0028169014084507044,0.9971830985915493,288,0.17746478873239438,0.4169014084507042,0.4056338028169014
72,37009,487,1,67,237,486,487,1.0,0.002053388090349076,0.997946611909651,183,0.1375770020533881,0.486652977412731,0.3757700205338809
73,37009,332,0,45,100,332,332,1.0,0.0,1.0,187,0.1355421686746988,0.30120481927710846,0.5632530120481928
74,37009,1439,0,241,538,1439,1439,1.0,0.0,1.0,660,0.1674774148714385,0.37387074357192496,0.4586518415566366
75,37009,2129,14,475,733,2115,2129,1.0,0.006575857209957727,0.9934241427900423,921,0.22310944105213715,0.3442930953499295,0.43259746359793333
76,37009,985,1,123,407,984,985,1.0,0.0010152284263959391,0.9989847715736041,455,0.12487309644670051,0.4131979695431472,0.4619289340101523
77,37009,535,0,92,130,535,535,1.0,0.0,1.0,313,0.17196261682242991,0.24299065420560748,0.5850467289719626
78,37009,585,2,89,229,583,585,1.0,0.003418803418803419,0.9965811965811966,267,0.15213675213675212,0.39145299145299145,0.4564102564102564
79,37009,200,1,31,68,199,200,1.0,0.005,0.995,101,0.155,0.34,0.505
80,37009,252,1,51,72,251,252,1.0,0.003968253968253968,0.996031746031746,129,0.20238095238095238,0.2857142857142857,0.5119047619047619
81,37009,500,1,88,200,499,500,1.0,0.002,0.998,212,0.176,0.4,0.424
82,37009,2094,11,393,868,2083,2094,1.0,0.0052531041069723014,0.9947468958930277,833,0.1876790830945559,0.4145176695319962,0.39780324737344797
83,37009,1122,4,220,468,1118,1122,1.0,0.0035650623885918,0.9964349376114082,434,0.19607843137254902,0.41711229946524064,0.3868092691622103
84,37009,2172,2,452,995,2170,2172,1.0,0.0009208103130755065,0.9990791896869244,725,0.20810313075506445,0.4581031307550645,0.3337937384898711
85,37009,3681,33,715,1213,3648,3681,1.0,0.008964955175224124,0.9910350448247759,1753,0.19424069546318934,0.3295300190165716,0.4762292855202391
86,37009,3827,41,766,1316,3786,3827,1.0,0.010713352495427228,0.9892866475045727,1745,0.20015678076822577,0.34387248497517636,0.45597073425659784
87,37011,320,0,32,162,320,320,1.0,0.0,1.0,126,0.1,0.50625,0.39375
88,37011,996,5,147,479,991,996,1.0,0.0050200803212851405,0.9949799196787149,370,0.14759036144578314,0.48092369477911645,0.3714859437751004
89,37011,547,0,50,250,547,547,1.0,0.0,1.0,247,0.09140767824497258,0.4570383912248629,0.4515539305301645
90,37011,2538,65,498,906,2473,2538,1.0,0.0256107171000788,0.9743892828999212,1134,0.19621749408983452,0.35697399527186763,0.44680851063829785
91,37011,501,4,34,164,497,501,1.0,0.007984031936127744,0.9920159680638723,303,0.06786427145708583,0.3273453093812375,0.6047904191616766
92,37011,365,0,31,219,365,365,1.0,0.0,1.0,115,0.08493150684931507,0.6,0.3150684931506849
93,37011,395,0,37,184,395,395,1.0,0.0,1.0,174,0.09367088607594937,0.46582278481012657,0.44050632911392407
94,37011,384,0,23,181,384,384,1.0,0.0,1.0,180,0.059895833333333336,0.4713541666666667,0.46875
95,37011,2709,577,116,383,2132,2709,1.0,0.2129937246216316,0.7870062753783684,2210,0.042820228866740494,0.14138058324104835,0.8157991878922112
96,37011,105,3,20,31,102,105,1.0,0.02857142857142857,0.9714285714285714,54,0.19047619047619047,0.29523809523809524,0.5142857142857142
97,37011,555,7,49,303,548,555,1.0,0.012612612612612612,0.9873873873873874,203,0.08828828828828829,0.5459459459459459,0.36576576576576575
98,37011,992,7,100,318,985,992,1.0,0.007056451612903226,0.9929435483870968,574,0.10080645161290322,0.32056451612903225,0.5786290322580645
99,37011,345,1,40,187,344,345,1.0,0.002898550724637681,0.9971014492753624,118,0.11594202898550725,0.5420289855072464,0.34202898550724636
100,37011,930,4,142,448,926,930,1.0,0.004301075268817204,0.9956989247311828,340,0.15268817204301074,0.4817204301075269,0.3655913978494624
101,37011,538,0,107,230,538,538,1.0,0.0,1.0,201,0.19888475836431227,0.4275092936802974,0.3736059479553903
102,37011,1031,2,230,586,1029,1031,1.0,0.0019398642095053346,0.9980601357904947,215,0.22308438409311349,0.5683802133850631,0.20853540252182348
103,37011,899,1,101,376,898,899,1.0,0.0011123470522803114,0.9988876529477196,422,0.11234705228031146,0.41824249165739713,0.4694104560622914
104,37011,235,4,24,127,231,235,1.0,0.01702127659574468,0.9829787234042553,84,0.10212765957446808,0.5404255319148936,0.3574468085106383
105,37011,353,0,101,232,353,353,1.0,0.0,1.0,20,0.28611898016997167,0.6572237960339944,0.056657223796033995
106,37013,2478,475,550,902,2003,2478,1.0,0.1916868442292171,0.8083131557707829,1026,0.22195318805488298,0.3640032284100081,0.41404358353510895
107,37013,1305,575,524,337,730,1305,1.0,0.44061302681992337,0.5593869731800766,444,0.40153256704980844,0.2582375478927203,0.34022988505747126
108,37013,1615,159,254,665,1456,1615,1.0,0.09845201238390093,0.9015479876160991,696,0.15727554179566564,0.4117647058823529,0.4309597523219814
109,37013,1690,753,712,361,937,1690,1.0,0.4455621301775148,0.5544378698224852,617,0.421301775147929,0.2136094674556213,0.3650887573964497
110,37013,841,274,292,317,567,841,1.0,0.3258026159334126,0.6741973840665874,232,0.34720570749108204,0.3769322235434007,0.27586206896551724
111,37013,1483,435,475,515,1048,1483,1.0,0.2933243425488874,0.7066756574511126,493,0.3202966958867161,0.3472690492245448,0.33243425488873907
112,37013,957,59,96,519,898,957,1.0,0.06165099268547544,0.9383490073145245,342,0.10031347962382445,0.542319749216301,0.3573667711598746
113,37013,1833,773,630,537,1060,1833,1.0,0.4217130387343153,0.5782869612656847,666,0.3436988543371522,0.29296235679214405,0.36333878887070375
114,37013,1897,185,483,1047,1712,1897,1.0,0.09752240379546652,0.9024775962045335,367,0.25461254612546125,0.5519240906694781,0.19346336320506063
115,37013,2650,398,470,1139,2252,2650,1.0,0.150188679245283,0.849811320754717,1041,0.17735849056603772,0.429811320754717,0.3928301886792453
116,37013,1507,920,834,220,587,1507,1.0,0.6104844061048441,0.38951559389515594,453,0.5534173855341739,0.145985401459854,0.30059721300597214
117,37013,4524,1004,841,1518,3520,4524,1.0,0.22192749778956675,0.7780725022104332,2165,0.1858974358974359,0.33554376657824936,0.47855879752431474
118,37013,1737,853,716,363,884,1737,1.0,0.491076568796776,0.5089234312032239,658,0.41220495106505467,0.20898100172711573,0.3788140472078296
119,37013,1392,457,321,501,935,1392,1.0,0.32830459770114945,0.6716954022988506,570,0.23060344827586207,0.3599137931034483,0.40948275862068967
120,37013,2571,624,682,849,1947,2571,1.0,0.2427071178529755,0.7572928821470245,1040,0.26526643329443794,0.33022170361726955,0.4045118630882925
121,37013,1846,101,202,967,1745,1846,1.0,0.05471289274106175,0.9452871072589383,677,0.1094257854821235,0.5238353196099675,0.366738894907909
122,37013,1190,428,327,348,762,1190,1.0,0.3596638655462185,0.6403361344537815,515,0.2747899159663866,0.292436974789916,0.4327731092436975
123,37013,1872,80,336,1026,1792,1872,1.0,0.042735042735042736,0.9572649572649573,510,0.1794871794871795,0.5480769230769231,0.2724358974358974
124,37013,912,87,110,482,825,912,1.0,0.09539473684210527,0.9046052631578947,320,0.1206140350877193,0.5285087719298246,0.3508771929824561
125,37013,1616,119,268,781,1497,1616,1.0,0.07363861386138613,0.9263613861386139,567,0.16584158415841585,0.4832920792079208,0.35086633663366334
126,37013,1316,257,312,583,1059,1316,1.0,0.1952887537993921,0.8047112462006079,421,0.23708206686930092,0.4430091185410334,0.31990881458966564
127,37015,1707,1096,790,289,611,1707,1.0,0.6420620972466315,0.3579379027533685,628,0.46280023432923256,0.169302870533099,0.36789689513766843
128,37015,849,421,298,256,428,849,1.0,0.4958775029446408,0.5041224970553593,295,0.3510011778563015,0.30153121319199055,0.3474676089517079
129,37015,986,470,302,337,516,986,1.0,0.4766734279918864,0.5233265720081136,347,0.30628803245436104,0.34178498985801214,0.35192697768762676
130,37015,811,463,379,215,348,811,1.0,0.5709001233045623,0.42909987669543775,217,0.46732429099876693,0.2651048088779285,0.2675709001233046
131,37015,764,24,38,455,740,764,1.0,0.031413612565445025,0.9685863874345549,271,0.049738219895287955,0.5955497382198953,0.35471204188481675
132,37015,5703,3712,2083,883,1991,5703,1.0,0.650885498860249,0.349114501139751,2737,0.3652463615640891,0.1548307908118534,0.4799228476240575
133,37015,983,578,387,177,405,983,1.0,0.5879959308240081,0.41200406917599186,419,0.3936927772126144,0.18006103763987794,0.4262461851475076
134,37015,1025,778,551,107,247,1025,1.0,0.7590243902439024,0.24097560975609755,367,0.5375609756097561,0.10439024390243902,0.35804878048780486
135,37015,1274,498,357,408,776,1274,1.0,0.39089481946624804,0.609105180533752,509,0.2802197802197802,0.3202511773940345,0.39952904238618525
136,37015,1050,879,608,65,171,1050,1.0,0.8371428571428572,0.16285714285714287,377,0.579047619047619,0.06190476190476191,0.35904761904761906
137,37015,1302,954,650,171,348,1302,1.0,0.7327188940092166,0.2672811059907834,481,0.49923195084485406,0.1313364055299539,0.369431643625192
138,37015,392,335,252,24,57,392,1.0,0.8545918367346939,0.14540816326530612,116,0.6428571428571429,0.061224489795918366,0.29591836734693877
139,37017,1607,245,305,706,1362,1607,1.0,0.15245799626633477,0.8475420037336652,596,0.1897946484131923,0.4393279402613566,0.37087741132545116
140,37017,813,202,211,275,611,813,1.0,0.24846248462484624,0.7515375153751538,327,0.25953259532595324,0.33825338253382536,0.4022140221402214
141,37017,3006,660,581,1043,2346,3006,1.0,0.21956087824351297,0.780439121756487,1382,0.19328010645375915,0.34697272122421824,0.4597471723220226
142,37017,1838,460,393,668,1378,1838,1.0,0.250272034820457,0.749727965179543,777,0.21381936887921654,0.3634385201305767,0.42274211099020675
143,37017,1414,608,419,348,806,1414,1.0,0.42998585572843,0.57001414427157,647,0.29632248939179634,0.24611032531824611,0.45756718528995755
144,37017,1503,911,821,109,592,1503,1.0,0.6061210911510313,0.39387890884896876,573,0.5462408516300732,0.07252162341982701,0.3812375249500998
145,37017,1439,830,687,210,609,1439,1.0,0.5767894371091036,0.4232105628908965,542,0.477414871438499,0.1459346768589298,0.3766504517025712
146,37017,1789,707,575,415,1082,1789,1.0,0.3951928451648966,0.6048071548351034,799,0.32140860816098377,0.2319731693683622,0.44661822247065397
147,37017,739,132,106,232,607,739,1.0,0.17861975642760486,0.8213802435723951,401,0.14343707713125844,0.31393775372124494,0.5426251691474966
148,37017,1410,378,330,369,1032,1410,1.0,0.2680851063829787,0.7319148936170212,711,0.23404255319148937,0.26170212765957446,0.5042553191489362
149,37017,551,178,198,140,373,551,1.0,0.32304900181488205,0.676950998185118,213,0.35934664246823955,0.2540834845735027,0.38656987295825773
150,37017,3314,616,634,1260,2698,3314,1.0,0.18587809293904647,0.8141219070609536,1420,0.19130959565479783,0.38020519010259507,0.4284852142426071
151,37017,923,372,305,189,551,923,1.0,0.40303358613217766,0.5969664138678223,429,0.3304442036836403,0.2047670639219935,0.4647887323943662
152,37017,3068,1475,1291,788,1593,3068,1.0,0.4807692307692308,0.5192307692307693,989,0.42079530638852675,0.25684485006518903,0.3223598435462842
153,37017,2092,974,756,496,1118,2092,1.0,0.4655831739961759,0.5344168260038241,840,0.361376673040153,0.23709369024856597,0.40152963671128106
154,37017,745,163,153,262,582,745,1.0,0.21879194630872484,0.7812080536912752,330,0.20536912751677852,0.3516778523489933,0.4429530201342282
155,37017,822,302,236,200,520,822,1.0,0.36739659367396593,0.6326034063260341,386,0.2871046228710462,0.24330900243309003,0.46958637469586373
156,37019,2693,221,764,1104,2472,2693,1.0,0.08206461195692537,0.9179353880430746,825,0.2836984775343483,0.4099517266988489,0.3063497957668028
157,37019,2259,15,566,1036,2244,2259,1.0,0.006640106241699867,0.9933598937583001,657,0.2505533421868083,0.4586100044267375,0.2908366533864542
158,37019,3584,99,676,1492,3485,3584,1.0,0.027622767857142856,0.9723772321428571,1416,0.18861607142857142,0.41629464285714285,0.3950892857142857
159,37019,5008,976,1560,2007,4032,5008,1.0,0.19488817891373802,0.805111821086262,1441,0.31150159744408945,0.40075878594249204,0.2877396166134185
160,37019,2003,517,562,553,1486,2003,1.0,0.2581128307538692,0.7418871692461309,888,0.28057913130304546,0.2760858711932102,0.4433349975037444
161,37019,2734,998,958,669,1736,2734,1.0,0.3650329188002926,0.6349670811997074,1107,0.35040234089246525,0.2446964155084126,0.40490124359912216
162,37019,4102,417,745,1138,3685,4102,1.0,0.10165772793759142,0.8983422720624086,2219,0.18161872257435396,0.27742564602632863,0.5409556313993175
163,37019,5600,296,1643,3206,5304,5600,1.0,0.05285714285714286,0.9471428571428572,751,0.2933928571428571,0.5725,0.13410714285714287
164,37019,3979,517,879,1364,3462,3979,1.0,0.12993214375471224,0.8700678562452877,1736,0.22090977632571,0.3427996984166876,0.4362905252576024
165,37019,4318,101,980,1758,4217,4318,1.0,0.023390458545622973,0.9766095414543771,1580,0.2269569245020843,0.40713293191292266,0.3659101435849931
166,37019,4341,90,1026,2162,4251,4341,1.0,0.02073255010366275,0.9792674498963373,1153,0.23635107118175536,0.49804192582354295,0.2656070029947017
167,37019,4246,150,885,2002,4096,4246,1.0,0.03532736693358455,0.9646726330664155,1359,0.20843146490814884,0.47150259067357514,0.320065944418276
168,37019,4918,337,1052,2279,4581,4918,1.0,0.06852379015860106,0.9314762098413989,1587,0.21390809272061814,0.4633997559983733,0.32269215128100853
169,37019,5287,1162,1394,1312,4125,5287,1.0,0.21978437677321733,0.7802156232267827,2581,0.26366559485530544,0.24815585398146398,0.48817855116323056
170,37019,2350,11,561,1054,2339,2350,1.0,0.004680851063829788,0.9953191489361702,735,0.23872340425531915,0.44851063829787235,0.3127659574468085
171,37019,4520,133,830,1933,4387,4520,1.0,0.029424778761061948,0.970575221238938,1757,0.1836283185840708,0.42765486725663715,0.38871681415929205
172,37019,3945,364,1091,1595,3581,3945,1.0,0.09226869455006337,0.9077313054499366,1259,0.276552598225602,0.40430925221799746,0.3191381495564005
173,37019,10931,1298,3435,4653,9633,10931,1.0,0.1187448540847132,0.8812551459152868,2843,0.3142438935138597,0.42567011252401427,0.26008599396212606
174,37019,1842,583,633,353,1259,1842,1.0,0.31650380021715524,0.6834961997828447,856,0.34364820846905536,0.19163952225841477,0.46471226927252984
175,37019,2448,171,373,751,2277,2448,1.0,0.06985294117647059,0.9301470588235294,1324,0.15236928104575165,0.306781045751634,0.5408496732026143
176,37019,3151,201,661,1188,2950,3151,1.0,0.06378927324658838,0.9362107267534117,1302,0.2097746747064424,0.37702316724849255,0.41320215804506505
177,37019,1944,476,450,606,1468,1944,1.0,0.2448559670781893,0.7551440329218106,888,0.23148148148148148,0.3117283950617284,0.4567901234567901
178,37019,1067,5,314,528,1062,1067,1.0,0.004686035613870665,0.9953139643861293,225,0.2942830365510778,0.4948453608247423,0.21087160262417995
179,37021,3266,376,1458,539,2890,3266,1.0,0.11512553582363748,0.8848744641763625,1269,0.4464176362522964,0.16503368034292712,0.3885486834047765
180,37021,4056,59,1359,1628,3997,4056,1.0,0.014546351084812623,0.9854536489151874,1069,0.33505917159763315,0.40138067061143984,0.263560157790927
181,37021,3169,77,798,1157,3092,3169,1.0,0.024297885768381194,0.9757021142316188,1214,0.25181445250867784,0.36509940044177974,0.38308614704954247
182,37021,4062,91,1282,1721,3971,4062,1.0,0.0224027572624323,0.9775972427375677,1059,0.3156080748399803,0.4236829148202856,0.26070901033973415
183,37021,3264,742,2195,159,2522,3264,1.0,0.22732843137254902,0.772671568627451,910,0.6724877450980392,0.04871323529411765,0.27879901960784315
184,37021,1758,88,811,315,1670,1758,1.0,0.05005688282138794,0.949943117178612,632,0.4613196814562002,0.17918088737201365,0.3594994311717861
185,37021,1559,82,953,301,1477,1559,1.0,0.05259781911481719,0.9474021808851828,305,0.6112892880051315,0.1930724823604875,0.19563822963438102
186,37021,2213,19,961,814,2194,2213,1.0,0.00858563036601898,0.991414369633981,438,0.4342521464075915,0.36782647989154993,0.19792137370085855
187,37021,999,122,561,164,877,999,1.0,0.12212212212212212,0.8778778778778779,274,0.5615615615615616,0.16416416416416416,0.27427427427427425
188,37021,1571,182,1036,226,1389,1571,1.0,0.1158497772119669,0.8841502227880331,309,0.6594525779758116,0.14385741565881605,0.19669000636537237
189,37021,1634,5,399,800,1629,1634,1.0,0.0030599755201958386,0.9969400244798041,435,0.2441860465116279,0.48959608323133413,0.26621787025703797
190,37021,4049,80,910,1382,3969,4049,1.0,0.01975796492961225,0.9802420350703878,1757,0.22474685107433934,0.3413188441590516,0.43393430476660905
191,37021,3129,38,745,1217,3091,3129,1.0,0.012144455097475231,0.9878555449025248,1167,0.23809523809523808,0.38894215404282517,0.37296260786193675
192,37021,4545,26,997,1703,4519,4545,1.0,0.00572057205720572,0.9942794279427942,1845,0.21936193619361935,0.3746974697469747,0.40594059405940597
193,37021,3409,63,1245,965,3346,3409,1.0,0.018480492813141684,0.9815195071868583,1199,0.3652097389263714,0.28307421531240834,0.3517160457612203
194,37021,2818,82,1022,588,2736,2818,1.0,0.029098651525904896,0.9709013484740951,1208,0.36266855926188785,0.20865862313697658,0.42867281760113557
195,37021,5027,237,2003,1583,4790,5027,1.0,0.04714541476029441,0.9528545852397056,1441,0.3984483787547245,0.31489954247065843,0.28665207877461707
196,37021,4819,84,1207,1654,4735,4819,1.0,0.017431002282631253,0.9825689977173687,1958,0.2504669018468562,0.34322473542228676,0.406308362730857
197,37021,1339,6,458,511,1333,1339,1.0,0.004480955937266617,0.9955190440627334,370,0.34204630321135177,0.3816280806572069,0.27632561613144135
198,37021,4849,310,2025,862,4539,4849,1.0,0.06393070736234276,0.9360692926376573,1962,0.4176118787378841,0.17776861208496597,0.40461950917714995
199,37021,4108,30,903,1505,4078,4108,1.0,0.007302823758519961,0.99269717624148,1700,0.21981499513145084,0.36635832521908474,0.41382667964946446
200,37021,1251,37,847,230,1214,1251,1.0,0.029576338928856916,0.9704236610711431,174,0.6770583533173461,0.1838529176658673,0.13908872901678657
201,37021,2403,370,1169,307,2033,2403,1.0,0.15397419891801914,0.8460258010819809,927,0.48647523928422803,0.12775697045359966,0.3857677902621723
202,37021,7282,1393,3043,1454,5889,7282,1.0,0.19129360065915957,0.8087063993408404,2785,0.4178797033781928,0.19967042021422687,0.3824498764075803
203,37021,3827,25,1278,1567,3802,3827,1.0,0.006532532009406846,0.9934674679905932,982,0.33394303632087796,0.4094591063496211,0.2565978573295009
204,37021,3404,25,1224,1313,3379,3404,1.0,0.007344300822561692,0.9926556991774383,867,0.3595769682726204,0.38572267920094006,0.25470035252643947
205,37021,2542,186,1032,571,2356,2542,1.0,0.07317073170731707,0.926829268292683,939,0.40597954366640443,0.22462627852084974,0.36939417781274586
206,37021,2174,89,580,692,2085,2174,1.0,0.04093836246550138,0.9590616375344986,902,0.2667893284268629,0.31830726770929163,0.41490340386384544
207,37021,2671,34,1636,747,2637,2671,1.0,0.01272931486334706,0.987270685136653,288,0.6125046798951703,0.27967053538000747,0.10782478472482217
208,37021,1242,36,517,426,1206,1242,1.0,0.028985507246376812,0.9710144927536232,299,0.41626409017713367,0.34299516908212563,0.24074074074074073
209,37021,1395,79,781,286,1316,1395,1.0,0.056630824372759854,0.9433691756272401,328,0.5598566308243728,0.2050179211469534,0.23512544802867383
210,37021,4540,359,1312,774,4181,4540,1.0,0.0790748898678414,0.9209251101321586,2454,0.2889867841409692,0.17048458149779736,0.5405286343612334
211,37021,2413,328,1525,153,2085,2413,1.0,0.13593037712391215,0.8640696228760879,735,0.6319933692498964,0.06340654786572732,0.3046000828843763
212,37021,2276,70,688,642,2206,2276,1.0,0.030755711775043937,0.9692442882249561,946,0.3022847100175747,0.2820738137082601,0.4156414762741652
213,37021,4486,82,1116,1389,4404,4486,1.0,0.018279090503789567,0.9817209094962104,1981,0.24877396344181898,0.30962995987516717,0.4415960766830138
214,37021,2681,68,874,1147,2613,2681,1.0,0.02536367027228646,0.9746363297277135,660,0.32599776202909364,0.42782543826930247,0.2461767997016039
215,37021,1863,22,568,713,1841,1863,1.0,0.011808910359634998,0.988191089640365,582,0.3048845947396672,0.38271604938271603,0.31239935587761675
216,37021,3939,315,1991,1101,3624,3939,1.0,0.07996953541507996,0.92003046458492,847,0.5054582381315055,0.2795125666412795,0.21502919522721503
217,37021,1053,5,381,638,1048,1053,1.0,0.004748338081671415,0.9952516619183286,34,0.36182336182336183,0.6058879392212726,0.032288698955365625
218,37021,3302,25,681,1186,3277,3302,1.0,0.007571168988491823,0.9924288310115081,1435,0.20623864324651725,0.3591762568140521,0.4345850999394307
219,37021,2021,185,802,477,1836,2021,1.0,0.09153884215734785,0.9084611578426521,742,0.396833250865908,0.23602177140029687,0.3671449777337952
220,37021,2244,22,1342,672,2222,2244,1.0,0.00980392156862745,0.9901960784313726,230,0.5980392156862745,0.2994652406417112,0.10249554367201426
221,37021,1423,458,816,65,965,1423,1.0,0.3218552354181307,0.6781447645818693,542,0.573436401967674,0.04567814476458187,0.3808854532677442
222,37021,2158,89,604,680,2069,2158,1.0,0.041241890639481,0.958758109360519,874,0.2798887859128823,0.31510658016682114,0.40500463392029656
223,37021,1613,1,410,579,1612,1613,1.0,0.0006199628022318661,0.9993800371977681,624,0.2541847489150651,0.35895846249225044,0.38685678859268446
224,37021,2870,98,1001,1202,2772,2870,1.0,0.03414634146341464,0.9658536585365853,667,0.348780487804878,0.418815331010453,0.232404181184669
225,37021,2124,611,1173,155,1513,2124,1.0,0.2876647834274953,0.7123352165725048,796,0.5522598870056498,0.07297551789077213,0.3747645951035782
226,37021,1412,0,456,500,1412,1412,1.0,0.0,1.0,456,0.32294617563739375,0.35410764872521244,0.32294617563739375
227,37021,1841,119,1141,204,1722,1841,1.0,0.06463878326996197,0.935361216730038,496,0.6197718631178707,0.11080934274850625,0.269418794133623
228,37021,2284,1025,1114,52,1259,2284,1.0,0.44877408056042034,0.5512259194395797,1118,0.48774080560420313,0.02276707530647986,0.489492119089317
229,37021,3176,114,851,1379,3062,3176,1.0,0.03589420654911839,0.9641057934508817,946,0.2679471032745592,0.43419395465994964,0.2978589420654912
230,37021,1830,207,394,275,1623,1830,1.0,0.11311475409836065,0.8868852459016393,1161,0.21530054644808744,0.15027322404371585,0.6344262295081967
231,37021,5795,33,1542,2374,5762,5795,1.0,0.005694564279551337,0.9943054357204487,1879,0.26609145815358065,0.4096635030198447,0.3242450388265746
232,37021,1087,26,525,361,1061,1087,1.0,0.02391904323827047,0.9760809567617296,201,0.48298068077276907,0.33210671573137074,0.18491260349586017
233,37021,2066,113,770,656,1953,2066,1.0,0.05469506292352372,0.9453049370764763,640,0.3727008712487899,0.31752178121974833,0.30977734753146174
234,37021,3079,96,887,786,2983,3079,1.0,0.03117895420591101,0.968821045794089,1406,0.2880805456316986,0.2552776875608964,0.456641766807405
235,37021,1895,44,1202,335,1851,1895,1.0,0.02321899736147757,0.9767810026385224,358,0.6343007915567282,0.17678100263852242,0.18891820580474933
236,37021,601,4,158,208,597,601,1.0,0.0066555740432612314,0.9933444259567388,235,0.2628951747088186,0.34608985024958405,0.3910149750415973
237,37021,4361,34,958,1576,4327,4361,1.0,0.007796376977757395,0.9922036230222426,1827,0.21967438660857602,0.3613850034395781,0.4189406099518459
238,37021,1050,17,473,323,1033,1050,1.0,0.01619047619047619,0.9838095238095238,254,0.4504761904761905,0.3076190476190476,0.2419047619047619
239,37021,2316,27,858,912,2289,2316,1.0,0.011658031088082901,0.9883419689119171,546,0.3704663212435233,0.39378238341968913,0.23575129533678757
240,37021,2052,60,642,504,1992,2052,1.0,0.029239766081871343,0.9707602339181286,906,0.3128654970760234,0.24561403508771928,0.4415204678362573
241,37021,2739,111,1554,300,2628,2739,1.0,0.040525739320920046,0.9594742606790799,885,0.5673603504928806,0.10952902519167579,0.3231106243154436
242,37021,4348,188,1361,1302,4160,4348,1.0,0.04323827046918123,0.9567617295308187,1685,0.31301747930082796,0.29944802207911686,0.3875344986200552
243,37021,7904,545,2813,2728,7359,7904,1.0,0.06895242914979757,0.9310475708502024,2363,0.35589574898785425,0.3451417004048583,0.29896255060728744
244,37021,2485,109,860,743,2376,2485,1.0,0.04386317907444668,0.9561368209255533,882,0.3460764587525151,0.29899396378269616,0.35492957746478876
245,37021,2317,403,1340,221,1914,2317,1.0,0.17393180837289599,0.826068191627104,756,0.5783340526542944,0.0953819594302978,0.32628398791540786
246,37023,2746,62,423,953,2684,2746,1.0,0.022578295702840496,0.9774217042971595,1370,0.1540422432629279,0.3470502549162418,0.4989075018208303
247,37023,564,1,114,202,563,564,1.0,0.0017730496453900709,0.99822695035461,248,0.20212765957446807,0.35815602836879434,0.4397163120567376
248,37023,3809,189,728,1195,3620,3809,1.0,0.04961932265686532,0.9503806773431347,1886,0.19112627986348124,0.3137306379627199,0.4951430821737989
249,37023,3694,286,857,1194,3408,3694,1.0,0.07742284786139686,0.9225771521386031,1643,0.23199783432593396,0.3232268543584191,0.444775311315647
250,37023,1682,16,308,540,1666,1682,1.0,0.009512485136741973,0.990487514863258,834,0.18311533888228299,0.3210463733650416,0.4958382877526754
251,37023,2050,123,424,620,1927,2050,1.0,0.06,0.94,1006,0.20682926829268292,0.3024390243902439,0.49073170731707316
252,37023,930,25,216,313,905,930,1.0,0.026881720430107527,0.9731182795698925,401,0.23225806451612904,0.3365591397849462,0.4311827956989247
253,37023,3525,44,361,1324,3481,3525,1.0,0.0124822695035461,0.9875177304964539,1840,0.1024113475177305,0.37560283687943263,0.5219858156028369
254,37023,565,33,164,257,532,565,1.0,0.0584070796460177,0.9415929203539823,144,0.2902654867256637,0.45486725663716815,0.25486725663716814
255,37023,853,132,276,354,721,853,1.0,0.15474794841735054,0.8452520515826495,223,0.3235638921453693,0.41500586166471276,0.26143024618991795
256,37023,1737,151,343,413,1586,1737,1.0,0.08693149107656879,0.9130685089234312,981,0.19746689694876224,0.2377662636729994,0.5647668393782384
257,37023,2729,292,487,707,2437,2729,1.0,0.10699890069622572,0.8930010993037742,1535,0.17845364602418468,0.2590692561377794,0.5624770978380359
258,37023,2349,175,713,591,2174,2349,1.0,0.07449978714346531,0.9255002128565347,1045,0.3035334184759472,0.2515964240102171,0.4448701575138357
259,37023,2290,34,346,857,2256,2290,1.0,0.014847161572052401,0.9851528384279477,1087,0.15109170305676856,0.374235807860262,0.47467248908296944
260,37023,3693,572,1160,1009,3121,3693,1.0,0.15488762523693475,0.8451123747630652,1524,0.314107771459518,0.27321960465746004,0.41267262388302195
261,37023,2034,138,617,789,1896,2034,1.0,0.06784660766961652,0.9321533923303835,628,0.3033431661750246,0.387905604719764,0.3087512291052114
262,37023,2230,37,430,762,2193,2230,1.0,0.016591928251121078,0.9834080717488789,1038,0.19282511210762332,0.3417040358744395,0.4654708520179372
263,37023,2711,174,539,793,2537,2711,1.0,0.06418295831796385,0.9358170416820362,1379,0.19881962375507192,0.2925119881962375,0.5086683880486905
264,37023,2767,474,826,404,2293,2767,1.0,0.17130466208890496,0.8286953379110951,1537,0.29851825081315503,0.14600650524033248,0.5554752439465125
265,37023,1886,275,573,391,1611,1886,1.0,0.14581124072110285,0.8541887592788971,922,0.30381760339342523,0.2073170731707317,0.48886532343584305
266,37023,2770,32,597,1055,2738,2770,1.0,0.011552346570397111,0.9884476534296028,1118,0.21552346570397113,0.38086642599277976,0.4036101083032491
267,37023,1947,31,227,704,1916,1947,1.0,0.015921931176168466,0.9840780688238315,1016,0.11658962506420134,0.3615819209039548,0.5218284540318439
268,37023,2558,322,545,479,2236,2558,1.0,0.12587959343236904,0.874120406567631,1534,0.2130570758405004,0.1872556684910086,0.599687255668491
269,37023,3430,36,378,1222,3394,3430,1.0,0.010495626822157435,0.9895043731778426,1830,0.11020408163265306,0.356268221574344,0.5335276967930029
270,37023,2791,17,439,806,2774,2791,1.0,0.006091006807595844,0.9939089931924041,1546,0.15729129344321033,0.2887853815836618,0.5539233249731279
271,37023,844,11,202,310,833,844,1.0,0.013033175355450236,0.9869668246445498,332,0.23933649289099526,0.36729857819905215,0.3933649289099526
272,37023,2738,25,554,1039,2713,2738,1.0,0.009130752373995616,0.9908692476260044,1145,0.20233747260774287,0.37947406866325784,0.4181884587289993
273,37023,1356,15,193,539,1341,1356,1.0,0.011061946902654867,0.9889380530973452,624,0.14233038348082597,0.3974926253687316,0.46017699115044247
274,37023,2674,9,258,994,2665,2674,1.0,0.0033657442034405387,0.9966342557965595,1422,0.09648466716529544,0.3717277486910995,0.531787584143605
275,37023,2068,8,195,1009,2060,2068,1.0,0.0038684719535783366,0.9961315280464217,864,0.09429400386847195,0.4879110251450677,0.41779497098646035
276,37023,2704,924,208,442,1780,2704,1.0,0.34171597633136097,0.658284023668639,2054,0.07692307692307693,0.16346153846153846,0.7596153846153846
277,37025,2201,376,456,513,1825,2201,1.0,0.1708314402544298,0.8291685597455702,1232,0.20717855520218081,0.23307587460245344,0.5597455701953657
278,37025,2780,781,836,342,1999,2780,1.0,0.28093525179856116,0.7190647482014388,1602,0.30071942446043165,0.12302158273381295,0.5762589928057554
279,37025,3155,778,977,914,2377,3155,1.0,0.24659270998415214,0.7534072900158478,1264,0.3096671949286846,0.2896988906497623,0.4006339144215531
280,37025,3457,656,1184,1536,2801,3457,1.0,0.1897599074341915,0.8102400925658085,737,0.34249349146658953,0.44431588082152157,0.21319062771188893
281,37025,2530,372,883,1277,2158,2530,1.0,0.14703557312252966,0.8529644268774703,370,0.34901185770750986,0.5047430830039525,0.14624505928853754
282,37025,3624,377,990,1743,3247,3624,1.0,0.10402869757174393,0.8959713024282561,891,0.2731788079470199,0.48096026490066224,0.2458609271523179
283,37025,1928,119,314,820,1809,1928,1.0,0.061721991701244816,0.9382780082987552,794,0.1628630705394191,0.42531120331950206,0.4118257261410788
284,37025,3342,421,788,1133,2921,3342,1.0,0.12597247157390784,0.8740275284260922,1421,0.2357869539198085,0.33901855176540996,0.42519449431478157
285,37025,3846,717,1153,975,3129,3846,1.0,0.18642745709828393,0.8135725429017161,1718,0.2997919916796672,0.2535101404056162,0.4466978679147166
286,37025,1432,116,386,660,1316,1432,1.0,0.08100558659217877,0.9189944134078212,386,0.26955307262569833,0.46089385474860334,0.26955307262569833
287,37025,2234,105,447,1120,2129,2234,1.0,0.047000895255147716,0.9529991047448523,667,0.20008952551477172,0.5013428827215757,0.29856759176365266
288,37025,4775,230,779,2320,4545,4775,1.0,0.048167539267015703,0.9518324607329843,1676,0.1631413612565445,0.48586387434554973,0.3509947643979058
289,37025,2582,135,661,1432,2447,2582,1.0,0.052285050348567,0.947714949651433,489,0.256003098373354,0.5546088303640588,0.18938807126258714
290,37025,4395,838,1817,1834,3557,4395,1.0,0.1906712172923777,0.8093287827076223,744,0.41342434584755405,0.417292377701934,0.16928327645051194
291,37025,5023,759,1647,2007,4264,5023,1.0,0.15110491738005177,0.8488950826199483,1369,0.3278916981883337,0.39956201473223174,0.2725462870794346
292,37025,2061,339,447,572,1722,2061,1.0,0.16448326055312956,0.8355167394468704,1042,0.21688500727802038,0.2775351770984959,0.5055798156234838
293,37025,3012,848,944,634,2164,3012,1.0,0.2815405046480744,0.7184594953519257,1434,0.31341301460823373,0.2104913678618858,0.4760956175298805
294,37025,2273,330,617,1228,1943,2273,1.0,0.14518257809062912,0.8548174219093708,428,0.27144742630884294,0.5402551693796744,0.18829740431148262
295,37025,2945,740,919,911,2205,2945,1.0,0.25127334465195245,0.7487266553480475,1115,0.31205432937181665,0.30933786078098474,0.37860780984719866
296,37025,1112,32,293,527,1080,1112,1.0,0.02877697841726619,0.9712230215827338,292,0.26348920863309355,0.4739208633093525,0.26258992805755393
297,37025,3571,446,875,1451,3125,3571,1.0,0.12489498739848783,0.8751050126015122,1245,0.24502940352842342,0.4063287594511341,0.34864183702044244
298,37025,3160,139,511,1342,3021,3160,1.0,0.0439873417721519,0.9560126582278481,1307,0.16170886075949367,0.42468354430379746,0.41360759493670884
299,37025,2540,583,655,534,1957,2540,1.0,0.2295275590551181,0.7704724409448819,1351,0.2578740157480315,0.21023622047244095,0.5318897637795276
300,37025,1584,501,536,447,1083,1584,1.0,0.3162878787878788,0.6837121212121212,601,0.3383838383838384,0.2821969696969697,0.37941919191919193
301,37025,2630,55,313,1273,2575,2630,1.0,0.02091254752851711,0.9790874524714829,1044,0.11901140684410647,0.48403041825095056,0.39695817490494295
302,37025,5408,881,1306,1484,4527,5408,1.0,0.16290680473372782,0.8370931952662722,2618,0.24149408284023668,0.2744082840236686,0.48409763313609466
303,37025,1620,1128,912,64,492,1620,1.0,0.6962962962962963,0.3037037037037037,644,0.562962962962963,0.03950617283950617,0.39753086419753086
304,37025,716,130,251,173,586,716,1.0,0.18156424581005587,0.8184357541899442,292,0.3505586592178771,0.24162011173184358,0.40782122905027934
305,37025,1695,367,496,528,1328,1695,1.0,0.21651917404129795,0.783480825958702,671,0.2926253687315634,0.31150442477876106,0.3958702064896755
306,37025,2058,114,528,947,1944,2058,1.0,0.05539358600583091,0.9446064139941691,583,0.2565597667638484,0.46015549076773565,0.28328474246841595
307,37025,3605,652,829,811,2953,3605,1.0,0.1808599167822469,0.8191400832177531,1965,0.22995839112343966,0.22496532593619972,0.5450762829403606
308,37025,4334,248,622,1891,4086,4334,1.0,0.05722196585140748,0.9427780341485925,1821,0.1435163820950623,0.436317489616982,0.4201661282879557
309,37025,1078,5,144,543,1073,1078,1.0,0.00463821892393321,0.9953617810760668,391,0.13358070500927643,0.5037105751391465,0.362708719851577
310,37025,1994,22,251,1121,1972,1994,1.0,0.011033099297893681,0.9889669007021064,622,0.12587763289869608,0.5621865596790371,0.3119358074222668
311,37025,2923,155,439,1392,2768,2923,1.0,0.05302771125555936,0.9469722887444406,1092,0.1501881628463907,0.4762230585015395,0.3735887786520698
312,37025,3463,271,802,1868,3192,3463,1.0,0.07825584753104245,0.9217441524689576,793,0.23159110597747617,0.5394166907305804,0.2289922032919434
313,37025,5529,641,1399,2250,4888,5529,1.0,0.11593416531018268,0.8840658346898174,1880,0.25302948091879185,0.40694519804666307,0.34002532103454514
314,37025,2237,320,548,861,1917,2237,1.0,0.1430487259722843,0.8569512740277156,828,0.24497094322753687,0.38489047831917744,0.3701385784532856
315,37025,2209,360,406,398,1849,2209,1.0,0.16296966953372566,0.8370303304662743,1405,0.18379357175192396,0.18017202354006337,0.6360344047080126
316,37025,2231,204,539,1273,2027,2231,1.0,0.09143881667413715,0.9085611833258629,419,0.2415956969968624,0.5705961452263559,0.18780815777678173
317,37025,968,17,178,540,951,968,1.0,0.01756198347107438,0.9824380165289256,250,0.18388429752066116,0.5578512396694215,0.25826446280991733
318,37025,3085,458,932,1270,2627,3085,1.0,0.14846029173419772,0.8515397082658023,883,0.3021069692058347,0.41166936790923825,0.28622366288492707
319,37025,2838,300,760,1140,2538,2838,1.0,0.10570824524312897,0.8942917547568711,938,0.2677942212825934,0.40169133192389006,0.33051444679351655
320,37025,2193,315,520,790,1878,2193,1.0,0.1436388508891929,0.8563611491108071,883,0.23711810305517556,0.3602371181030552,0.40264477884176925
321,37025,2485,271,471,875,2214,2485,1.0,0.1090543259557344,0.8909456740442656,1139,0.18953722334004025,0.352112676056338,0.45835010060362175
322,37025,4369,510,1057,1747,3859,4369,1.0,0.11673151750972763,0.8832684824902723,1565,0.24193179217212177,0.39986266880292975,0.3582055390249485
323,37027,2189,75,262,868,2114,2189,1.0,0.034262220191868434,0.9657377798081316,1059,0.11968935587026039,0.39652809502055736,0.4837825491091823
324,37027,1772,223,352,462,1549,1772,1.0,0.12584650112866816,0.8741534988713319,958,0.1986455981941309,0.26072234762979685,0.5406320541760722
325,37027,1862,29,324,677,1833,1862,1.0,0.015574650912996778,0.9844253490870032,861,0.17400644468313642,0.3635875402792696,0.462406015037594
326,37027,1349,53,253,473,1296,1349,1.0,0.039288361749444035,0.9607116382505559,623,0.18754633061527057,0.3506300963676798,0.4618235730170497
327,37027,2012,57,392,785,1955,2012,1.0,0.028330019880715707,0.9716699801192843,835,0.19483101391650098,0.39015904572564614,0.4150099403578529
328,37027,944,9,152,400,935,944,1.0,0.009533898305084746,0.9904661016949152,392,0.16101694915254236,0.423728813559322,0.4152542372881356
329,37027,4106,67,875,1897,4039,4106,1.0,0.01631758402338042,0.9836824159766195,1334,0.2131027764247443,0.46200681928884557,0.32489040428641014
330,37027,3483,26,466,1402,3457,3483,1.0,0.007464829170255527,0.9925351708297445,1615,0.1337927074361183,0.40252655756531724,0.46368073499856444
331,37027,2888,425,530,508,2463,2888,1.0,0.1471606648199446,0.8528393351800554,1850,0.1835180055401662,0.17590027700831026,0.6405817174515236
332,37027,1985,404,606,424,1581,1985,1.0,0.2035264483627204,0.7964735516372796,955,0.3052896725440806,0.2136020151133501,0.4811083123425693
333,37027,2334,25,300,848,2309,2334,1.0,0.010711225364181662,0.9892887746358183,1186,0.12853470437017994,0.363324764353042,0.508140531276778
334,37027,3952,357,800,946,3595,3952,1.0,0.09033400809716599,0.909665991902834,2206,0.20242914979757085,0.23937246963562753,0.5581983805668016
335,37027,2305,14,321,798,2291,2305,1.0,0.006073752711496746,0.9939262472885032,1186,0.13926247288503255,0.3462039045553145,0.514533622559653
336,37027,3843,66,516,1425,3777,3843,1.0,0.01717408274785324,0.9828259172521467,1902,0.13427010148321625,0.3708040593286495,0.49492583918813426
337,37027,2842,109,398,1006,2733,2842,1.0,0.038353272343420126,0.9616467276565799,1438,0.14004222378606615,0.35397607318789587,0.505981703026038
338,37027,3531,3,455,1475,3528,3531,1.0,0.0008496176720475786,0.9991503823279524,1601,0.12885868026054942,0.41772868875672614,0.45341263098272444
339,37027,3014,23,571,1592,2991,3014,1.0,0.007631055076310551,0.9923689449236894,851,0.18944923689449236,0.5282017252820173,0.28234903782349036
340,37027,4350,359,808,1330,3991,4350,1.0,0.08252873563218391,0.9174712643678161,2212,0.1857471264367816,0.3057471264367816,0.5085057471264368
341,37027,3939,58,570,1618,3881,3939,1.0,0.014724549378014725,0.9852754506219853,1751,0.1447067783701447,0.41076415333841076,0.4445290682914445
342,37027,4496,22,505,1907,4474,4496,1.0,0.004893238434163701,0.9951067615658363,2084,0.11232206405693951,0.42415480427046265,0.46352313167259784
343,37027,1925,21,297,819,1904,1925,1.0,0.01090909090909091,0.9890909090909091,809,0.15428571428571428,0.4254545454545455,0.4202597402597403
344,37027,1378,460,566,242,918,1378,1.0,0.33381712626995647,0.6661828737300436,570,0.4107402031930334,0.17561683599419448,0.41364296081277213
345,37027,3744,61,579,1327,3683,3744,1.0,0.016292735042735044,0.9837072649572649,1838,0.1546474358974359,0.3544337606837607,0.4909188034188034
346,37029,2688,429,518,1030,2259,2688,1.0,0.15959821428571427,0.8404017857142857,1140,0.19270833333333334,0.38318452380952384,0.42410714285714285
347,37029,1919,165,341,802,1754,1919,1.0,0.0859822824387702,0.9140177175612298,776,0.17769671704012507,0.4179260031266285,0.4043772798332465
348,37029,2816,413,649,1277,2403,2816,1.0,0.14666193181818182,0.8533380681818182,890,0.23046875,0.45348011363636365,0.31605113636363635
349,37031,331,1,39,133,330,331,1.0,0.0030211480362537764,0.9969788519637462,159,0.11782477341389729,0.40181268882175225,0.48036253776435045
350,37031,584,1,110,229,583,584,1.0,0.0017123287671232876,0.9982876712328768,245,0.18835616438356165,0.3921232876712329,0.4195205479452055
351,37031,535,56,149,233,479,535,1.0,0.10467289719626169,0.8953271028037383,153,0.27850467289719627,0.4355140186915888,0.28598130841121494
352,37031,1272,57,163,612,1215,1272,1.0,0.04481132075471698,0.9551886792452831,497,0.1281446540880503,0.4811320754716981,0.39072327044025157
353,37031,650,363,327,159,287,650,1.0,0.5584615384615385,0.44153846153846155,164,0.5030769230769231,0.24461538461538462,0.2523076923076923
354,37031,352,0,38,177,352,352,1.0,0.0,1.0,137,0.10795454545454546,0.5028409090909091,0.38920454545454547
355,37031,1205,4,306,702,1201,1205,1.0,0.0033195020746887966,0.9966804979253112,197,0.25394190871369293,0.5825726141078839,0.16348547717842324
356,37031,3265,167,691,1674,3098,3265,1.0,0.05114854517611026,0.9488514548238898,900,0.2116385911179173,0.5127105666156202,0.27565084226646247
357,37031,1299,131,278,552,1168,1299,1.0,0.100846805234796,0.8991531947652041,469,0.21401077752117012,0.42494226327944573,0.3610469591993841
358,37031,699,10,64,350,689,699,1.0,0.01430615164520744,0.9856938483547926,285,0.09155937052932761,0.5007153075822603,0.40772532188841204
359,37031,343,2,51,155,341,343,1.0,0.0058309037900874635,0.9941690962099126,137,0.14868804664723032,0.4518950437317784,0.39941690962099125
360,37031,176,0,15,91,176,176,1.0,0.0,1.0,70,0.08522727272727272,0.5170454545454546,0.3977272727272727
361,37031,468,3,45,102,465,468,1.0,0.00641025641025641,0.9935897435897436,321,0.09615384615384616,0.21794871794871795,0.6858974358974359
362,37031,251,0,29,101,251,251,1.0,0.0,1.0,121,0.11553784860557768,0.40239043824701193,0.4820717131474104
363,37031,284,0,50,143,284,284,1.0,0.0,1.0,91,0.176056338028169,0.5035211267605634,0.3204225352112676
364,37031,3123,20,679,1642,3103,3123,1.0,0.006404098623118796,0.9935959013768813,802,0.21741914825488312,0.5257764969580532,0.2568043547870637
365,37031,2275,53,319,1001,2222,2275,1.0,0.023296703296703296,0.9767032967032967,955,0.1402197802197802,0.44,0.4197802197802198
366,37031,1360,12,260,820,1348,1360,1.0,0.008823529411764706,0.9911764705882353,280,0.19117647058823528,0.6029411764705882,0.20588235294117646
367,37031,3148,320,690,1052,2828,3148,1.0,0.10165184243964422,0.8983481575603558,1406,0.21918678526048285,0.3341804320203304,0.44663278271918677
368,37031,572,6,47,298,566,572,1.0,0.01048951048951049,0.9895104895104895,227,0.08216783216783216,0.5209790209790209,0.3968531468531469
369,37031,2286,116,367,1269,2170,2286,1.0,0.05074365704286964,0.9492563429571304,650,0.1605424321959755,0.5551181102362205,0.28433945756780404
370,37031,3966,230,636,1592,3736,3966,1.0,0.05799293998991427,0.9420070600100857,1738,0.16036308623298035,0.4014120020171457,0.43822491174987394
371,37031,2526,285,577,951,2241,2526,1.0,0.11282660332541568,0.8871733966745843,998,0.22842438638163104,0.37648456057007124,0.3950910530482977
372,37031,3624,287,905,1384,3337,3624,1.0,0.07919426048565122,0.9208057395143487,1335,0.24972406181015452,0.3818984547461369,0.36837748344370863
373,37031,1228,6,193,581,1222,1228,1.0,0.004885993485342019,0.995114006514658,454,0.15716612377850162,0.4731270358306189,0.3697068403908795
374,37031,2645,21,427,1552,2624,2645,1.0,0.007939508506616257,0.9920604914933837,666,0.1614366729678639,0.5867674858223062,0.25179584120982984
375,37031,1529,294,556,433,1235,1529,1.0,0.19228253760627861,0.8077174623937214,540,0.36363636363636365,0.2831916285153695,0.35317200784826686
376,37031,1960,8,248,910,1952,1960,1.0,0.004081632653061225,0.9959183673469387,802,0.12653061224489795,0.4642857142857143,0.4091836734693878
377,37031,2545,19,511,1506,2526,2545,1.0,0.007465618860510805,0.9925343811394892,528,0.20078585461689588,0.5917485265225934,0.2074656188605108
378,37031,322,1,81,139,321,322,1.0,0.003105590062111801,0.9968944099378882,102,0.2515527950310559,0.43167701863354035,0.3167701863354037
379,37031,1055,0,149,627,1055,1055,1.0,0.0,1.0,279,0.14123222748815165,0.5943127962085308,0.26445497630331755
380,37031,3076,141,364,1375,2935,3076,1.0,0.045838751625487645,0.9541612483745123,1337,0.11833550065019506,0.44700910273081923,0.4346553966189857
381,37031,4488,442,657,1587,4046,4488,1.0,0.09848484848484848,0.9015151515151515,2244,0.1463903743315508,0.3536096256684492,0.5
382,37031,452,0,85,212,452,452,1.0,0.0,1.0,155,0.18805309734513273,0.4690265486725664,0.34292035398230086
383,37033,3514,663,768,1275,2851,3514,1.0,0.18867387592487195,0.811326124075128,1471,0.21855435401252135,0.36283437677859987,0.41861126920887876
384,37033,2380,1186,881,520,1194,2380,1.0,0.49831932773109244,0.5016806722689076,979,0.3701680672268908,0.2184873949579832,0.41134453781512603
385,37033,914,217,236,353,697,914,1.0,0.237417943107221,0.762582056892779,325,0.25820568927789933,0.3862144420131291,0.35557986870897157
386,37033,2486,559,574,841,1927,2486,1.0,0.2248592115848753,0.7751407884151247,1071,0.23089300080450523,0.33829444891391797,0.43081255028157683
387,37033,2652,1168,489,448,1484,2652,1.0,0.44042232277526394,0.5595776772247361,1715,0.18438914027149322,0.1689291101055807,0.6466817496229261
388,37033,966,543,476,202,423,966,1.0,0.562111801242236,0.43788819875776397,288,0.4927536231884058,0.20910973084886128,0.2981366459627329
389,37033,2256,1116,965,568,1140,2256,1.0,0.4946808510638298,0.5053191489361702,723,0.42774822695035464,0.25177304964539005,0.3204787234042553
390,37033,721,281,236,225,440,721,1.0,0.3897364771151179,0.6102635228848821,260,0.3273231622746186,0.3120665742024965,0.3606102635228849
391,37033,1076,399,332,328,677,1076,1.0,0.370817843866171,0.629182156133829,416,0.30855018587360594,0.3048327137546468,0.38661710037174724
392,37033,971,128,168,435,843,971,1.0,0.13182286302780638,0.8681771369721936,368,0.17301750772399588,0.44799176107106076,0.37899073120494337
393,37033,894,196,223,399,698,894,1.0,0.21923937360178972,0.7807606263982103,272,0.2494407158836689,0.4463087248322148,0.3042505592841163
394,37035,2779,174,448,1023,2605,2779,1.0,0.06261245052177042,0.9373875494782296,1308,0.16120906801007556,0.36811802806765026,0.4706729039222742
395,37035,4300,168,783,1961,4132,4300,1.0,0.03906976744186046,0.9609302325581396,1556,0.18209302325581395,0.456046511627907,0.36186046511627906
396,37035,3840,187,849,1885,3653,3840,1.0,0.04869791666666667,0.9513020833333333,1106,0.22109375,0.4908854166666667,0.28802083333333334
397,37035,3258,344,760,720,2914,3258,1.0,0.10558624923265807,0.894413750767342,1778,0.2332719459791283,0.22099447513812154,0.5457335788827502
398,37035,2382,30,369,1129,2352,2382,1.0,0.012594458438287154,0.9874055415617129,884,0.15491183879093198,0.4739714525608732,0.3711167086481948
399,37035,2878,330,574,666,2548,2878,1.0,0.11466296038915914,0.8853370396108409,1638,0.19944405837387075,0.231410701876303,0.5691452397498262
400,37035,2577,89,676,1407,2488,2577,1.0,0.03453628249902988,0.9654637175009702,494,0.26232052774544046,0.5459837019790454,0.19169577027551415
401,37035,1961,313,487,582,1648,1961,1.0,0.15961244263131055,0.8403875573686894,892,0.24834268230494647,0.296787353391127,0.45486996430392657
402,37035,4915,182,969,2319,4733,4915,1.0,0.037029501525941,0.962970498474059,1627,0.19715157680569684,0.4718209562563581,0.33102746693794505
403,37035,2770,94,526,1253,2676,2770,1.0,0.03393501805054152,0.9660649819494584,991,0.18989169675090253,0.4523465703971119,0.35776173285198554
404,37035,2284,438,595,330,1846,2284,1.0,0.19176882661996497,0.808231173380035,1359,0.260507880910683,0.14448336252189142,0.5950087565674256
405,37035,4367,270,727,1363,4097,4367,1.0,0.061827341424318755,0.9381726585756812,2277,0.16647584153881384,0.312113579116098,0.5214105793450882
406,37035,3176,30,518,1641,3146,3176,1.0,0.009445843828715366,0.9905541561712846,1017,0.16309823677581864,0.5166876574307305,0.3202141057934509
407,37035,1572,50,440,705,1522,1572,1.0,0.031806615776081425,0.9681933842239185,427,0.27989821882951654,0.4484732824427481,0.27162849872773537
408,37035,4193,203,701,2092,3990,4193,1.0,0.048414023372287146,0.9515859766277128,1400,0.16718340090627237,0.49892678273312663,0.333889816360601
409,37035,2013,906,952,199,1107,2013,1.0,0.45007451564828616,0.5499254843517138,862,0.47292598112270245,0.09885742672627919,0.42821659215101837
410,37035,3788,80,466,1776,3708,3788,1.0,0.021119324181626188,0.9788806758183738,1546,0.12302006335797254,0.46884899683210135,0.4081309398099261
411,37035,932,186,257,244,746,932,1.0,0.19957081545064378,0.8004291845493562,431,0.2757510729613734,0.26180257510729615,0.4624463519313305
412,37035,2712,111,376,1233,2601,2712,1.0,0.04092920353982301,0.959070796460177,1103,0.13864306784660768,0.45464601769911506,0.40671091445427726
413,37035,2296,112,553,1082,2184,2296,1.0,0.04878048780487805,0.9512195121951219,661,0.24085365853658536,0.4712543554006969,0.28789198606271776
414,37035,1604,220,369,370,1384,1604,1.0,0.1371571072319202,0.8628428927680798,865,0.2300498753117207,0.23067331670822944,0.5392768079800498
415,37035,4153,288,1010,1443,3865,4153,1.0,0.0693474596677101,0.93065254033229,1700,0.24319768841801107,0.34745966771008907,0.40934264387189984
416,37035,744,238,284,120,506,744,1.0,0.31989247311827956,0.6801075268817204,340,0.3817204301075269,0.16129032258064516,0.45698924731182794
417,37035,3697,409,760,1201,3288,3697,1.0,0.11063024073573167,0.8893697592642683,1736,0.20557208547470923,0.32485799296727075,0.46956992155802
418,37035,3672,323,677,1457,3349,3672,1.0,0.08796296296296297,0.9120370370370371,1538,0.1843681917211329,0.3967864923747277,0.4188453159041394
419,37035,1909,77,280,854,1832,1909,1.0,0.04033525405971713,0.9596647459402828,775,0.14667365112624411,0.44735463593504454,0.40597171293871137
420,37035,4105,280,738,1409,3825,4105,1.0,0.0682095006090134,0.9317904993909866,1958,0.17978075517661388,0.34323995127892815,0.476979293544458
421,37035,2265,130,452,1146,2135,2265,1.0,0.05739514348785872,0.9426048565121413,667,0.19955849889624724,0.5059602649006623,0.2944812362030905
422,37035,2444,262,442,541,2182,2444,1.0,0.1072013093289689,0.8927986906710311,1461,0.18085106382978725,0.22135842880523732,0.5977905073649754
423,37035,7073,236,1148,2856,6837,7073,1.0,0.03336632263537396,0.966633677364626,3069,0.16230736603986992,0.4037890569772374,0.43390357698289267
424,37035,2842,71,418,1218,2771,2842,1.0,0.02498240675580577,0.9750175932441942,1206,0.1470795214637579,0.42857142857142855,0.4243490499648135
425,37035,3468,305,604,875,3163,3468,1.0,0.08794694348327567,0.9120530565167243,1989,0.17416378316032297,0.25230680507497116,0.5735294117647058
426,37035,1809,76,477,848,1733,1809,1.0,0.04201216141514649,0.9579878385848535,484,0.263681592039801,0.46876727473742397,0.267551133222775
427,37035,1365,192,291,447,1173,1365,1.0,0.14065934065934066,0.8593406593406593,627,0.21318681318681318,0.3274725274725275,0.4593406593406593
428,37035,3639,448,850,1088,3191,3639,1.0,0.1231107447100852,0.8768892552899148,1701,0.23358065402583128,0.298983237153064,0.4674361088211047
429,37035,3049,334,717,886,2715,3049,1.0,0.10954411282387667,0.8904558871761233,1446,0.23515906854706461,0.29058707773040343,0.474253853722532
430,37035,3452,462,853,1100,2990,3452,1.0,0.13383545770567787,0.8661645422943222,1499,0.2471031286210892,0.3186558516801854,0.43424101969872536
431,37035,858,715,633,5,143,858,1.0,0.8333333333333334,0.16666666666666666,220,0.7377622377622378,0.005827505827505828,0.2564102564102564
432,37035,4442,153,599,1803,4289,4442,1.0,0.03444394416929311,0.9655560558307069,2040,0.13484916704187302,0.4058982440342188,0.45925258892390813
433,37035,1980,23,436,1257,1957,1980,1.0,0.011616161616161616,0.9883838383838384,287,0.2202020202020202,0.6348484848484849,0.14494949494949494
434,37037,6508,1429,2820,1966,5079,6508,1.0,0.2195759065765212,0.7804240934234788,1722,0.43331284572833434,0.3020897357098955,0.2645974185617701
435,37037,1969,250,971,512,1719,1969,1.0,0.12696800406297612,0.8730319959370239,486,0.4931437277805993,0.2600304723209751,0.2468257998984256
436,37037,880,60,111,478,820,880,1.0,0.06818181818181818,0.9318181818181818,291,0.12613636363636363,0.5431818181818182,0.3306818181818182
437,37037,5209,461,2371,1716,4748,5209,1.0,0.08850067191399501,0.911499328086005,1122,0.4551737377615665,0.3294298329813784,0.2153964292570551
438,37037,3908,83,1855,1394,3825,3908,1.0,0.021238485158648925,0.9787615148413511,659,0.47466734902763563,0.35670419651995905,0.16862845445240532
439,37037,1654,195,361,665,1459,1654,1.0,0.11789600967351874,0.8821039903264812,628,0.21825876662636035,0.40205562273276907,0.37968561064087064
440,37037,2642,597,702,937,2045,2642,1.0,0.2259651778955337,0.7740348221044663,1003,0.2657077971233914,0.3546555639666919,0.3796366389099167
441,37037,948,139,333,380,809,948,1.0,0.14662447257383968,0.8533755274261603,235,0.3512658227848101,0.4008438818565401,0.2478902953586498
442,37037,1587,97,482,710,1490,1587,1.0,0.06112161310649023,0.9388783868935098,395,0.3037177063642092,0.4473850031505986,0.24889729048519219
443,37037,4227,326,2530,1080,3901,4227,1.0,0.07712325526378046,0.9228767447362195,617,0.5985332387035722,0.255500354861604,0.14596640643482375
444,37037,2016,156,394,790,1860,2016,1.0,0.07738095238095238,0.9226190476190477,832,0.19543650793650794,0.39186507936507936,0.4126984126984127
445,37037,3853,678,896,925,3175,3853,1.0,0.17596677913314301,0.824033220866857,2032,0.23254606799896185,0.24007267064624968,0.5273812613547885
446,37037,839,12,84,447,827,839,1.0,0.014302741358760428,0.9856972586412396,308,0.10011918951132301,0.532777115613826,0.367103694874851
447,37037,1377,29,507,581,1348,1377,1.0,0.021060275962236745,0.9789397240377633,289,0.3681917211328976,0.42193173565722586,0.20987654320987653
448,37037,5912,1330,1584,1216,4582,5912,1.0,0.22496617050067658,0.7750338294993234,3112,0.2679296346414073,0.20568335588633288,0.5263870094722598
449,37037,1680,239,544,656,1441,1680,1.0,0.14226190476190476,0.8577380952380952,480,0.3238095238095238,0.3904761904761905,0.2857142857142857
450,37037,1958,379,608,749,1579,1958,1.0,0.19356486210418794,0.806435137895812,601,0.3105209397344229,0.3825331971399387,0.30694586312563843
451,37037,2672,192,1208,1463,2480,2672,1.0696836203444133,0.0718562874251497,0.9281437125748503,1,0.45209580838323354,0.5475299401197605,0.00037425149700598805
452,37039,1296,7,194,573,1289,1296,1.0,0.005401234567901234,0.9945987654320988,529,0.14969135802469136,0.44212962962962965,0.408179012345679
453,37039,1897,2,289,871,1895,1897,1.0,0.0010542962572482868,0.9989457037427517,737,0.15234580917237744,0.4591460200316289,0.3885081707959937
454,37039,1101,1,119,472,1100,1101,1.0,0.0009082652134423251,0.9990917347865577,510,0.1080835603996367,0.4287011807447775,0.46321525885558584
455,37039,755,1,80,425,754,755,1.0,0.0013245033112582781,0.9986754966887417,250,0.10596026490066225,0.5629139072847682,0.33112582781456956
456,37039,2461,10,355,1032,2451,2461,1.0,0.0040633888663145065,0.9959366111336855,1074,0.14425030475416498,0.41934173100365707,0.436407964242178
457,37039,1141,4,187,494,1137,1141,1.0,0.0035056967572304996,0.9964943032427696,460,0.16389132340052587,0.4329535495179667,0.40315512708150747
458,37039,2427,23,404,944,2404,2427,1.0,0.009476720230737536,0.9905232797692625,1079,0.1664606510094767,0.38895756077461885,0.4445817882159044
459,37039,2442,15,348,982,2427,2442,1.0,0.006142506142506142,0.9938574938574939,1112,0.14250614250614252,0.4021294021294021,0.45536445536445536
460,37039,1819,36,292,755,1783,1819,1.0,0.019791094007696537,0.9802089059923035,772,0.1605277625068719,0.41506322155030234,0.4244090159428257
461,37039,1838,9,275,630,1829,1838,1.0,0.004896626768226333,0.9951033732317737,933,0.14961915125136016,0.34276387377584333,0.5076169749727966
462,37039,2328,124,421,844,2204,2328,1.0,0.05326460481099656,0.9467353951890034,1063,0.18084192439862543,0.36254295532646047,0.4566151202749141
463,37039,1486,12,204,653,1474,1486,1.0,0.008075370121130552,0.9919246298788694,629,0.13728129205921938,0.43943472409152085,0.42328398384925975
464,37039,518,4,64,227,514,518,1.0,0.007722007722007722,0.9922779922779923,227,0.12355212355212356,0.43822393822393824,0.43822393822393824
465,37039,648,3,146,376,645,648,1.0,0.004629629629629629,0.9953703703703703,126,0.22530864197530864,0.5802469135802469,0.19444444444444445
466,37041,1053,204,199,434,849,1053,1.0,0.19373219373219372,0.8062678062678063,420,0.1889838556505223,0.4121557454890788,0.39886039886039887
467,37041,994,433,320,320,561,994,1.0,0.43561368209255535,0.5643863179074446,354,0.32193158953722334,0.32193158953722334,0.3561368209255533
468,37041,3437,1330,1257,1167,2107,3437,1.0,0.3869653767820774,0.6130346232179226,1013,0.36572592377073027,0.33954029677043934,0.2947337794588304
469,37041,1674,401,487,644,1273,1674,1.0,0.23954599761051373,0.7604540023894862,543,0.2909199522102748,0.3847072879330944,0.32437275985663083
470,37041,1841,78,234,849,1763,1841,1.0,0.042368278109722976,0.957631721890277,758,0.12710483432916894,0.46116241173275396,0.4117327539380771
471,37041,2477,1294,1059,477,1183,2477,1.0,0.5224061364553896,0.4775938635446104,941,0.4275333064190553,0.1925716592652402,0.3798950343157045
472,37043,861,3,185,375,858,861,1.0,0.003484320557491289,0.9965156794425087,301,0.2148664343786295,0.4355400696864111,0.34959349593495936
473,37043,759,4,148,320,755,759,1.0,0.005270092226613966,0.994729907773386,291,0.19499341238471674,0.42160737812911725,0.383399209486166
474,37043,1476,7,292,619,1469,1476,1.0,0.0047425474254742545,0.9952574525745257,565,0.1978319783197832,0.41937669376693765,0.38279132791327913
475,37043,1314,8,226,656,1306,1314,1.0,0.0060882800608828,0.9939117199391172,432,0.1719939117199391,0.4992389649923896,0.3287671232876712
476,37043,1236,4,159,617,1232,1236,1.0,0.003236245954692557,0.9967637540453075,460,0.12864077669902912,0.49919093851132684,0.37216828478964403
477,37043,624,1,127,325,623,624,1.0,0.0016025641025641025,0.9983974358974359,172,0.20352564102564102,0.5208333333333334,0.27564102564102566
478,37043,688,2,140,319,686,688,1.0,0.0029069767441860465,0.997093023255814,229,0.20348837209302326,0.4636627906976744,0.3328488372093023
479,37043,1102,13,224,556,1089,1102,1.0,0.011796733212341199,0.9882032667876588,322,0.20326678765880218,0.5045372050816697,0.29219600725952816
480,37043,544,2,78,186,542,544,1.0,0.003676470588235294,0.9963235294117647,280,0.14338235294117646,0.34191176470588236,0.5147058823529411
481,37045,3749,783,801,1265,2966,3749,1.0,0.2088556948519605,0.7911443051480395,1683,0.2136569751933849,0.3374233128834356,0.44891971192317953
482,37045,1437,3,108,744,1434,1437,1.0,0.0020876826722338203,0.9979123173277662,585,0.07515657620041753,0.5177453027139874,0.407098121085595
483,37045,1969,611,652,557,1358,1969,1.0,0.31030980192991364,0.6896901980700864,760,0.33113255459624175,0.28288471305231083,0.3859827323514474
484,37045,2725,839,901,862,1886,2725,1.0,0.30788990825688073,0.6921100917431192,962,0.33064220183486237,0.3163302752293578,0.3530275229357798
485,37045,2707,121,368,1095,2586,2707,1.0,0.04469892870336165,0.9553010712966383,1244,0.13594384927964537,0.4045068341337274,0.4595493165866273
486,37045,2909,417,645,1143,2492,2909,1.0,0.143348229632176,0.856651770367824,1121,0.22172567892746647,0.392918528704022,0.38535579236851153
487,37045,5028,580,792,1813,4448,5028,1.0,0.11535401750198886,0.8846459824980112,2423,0.1575178997613365,0.3605807478122514,0.4819013524264121
488,37045,2464,55,289,925,2409,2464,1.0,0.022321428571428572,0.9776785714285714,1250,0.11728896103896104,0.37540584415584416,0.5073051948051948
489,37045,3395,267,414,1296,3128,3395,1.0,0.07864506627393225,0.9213549337260677,1685,0.1219440353460972,0.38173784977908687,0.4963181148748159
490,37045,3752,502,613,1311,3250,3752,1.0,0.1337953091684435,0.8662046908315565,1828,0.16337953091684435,0.3494136460554371,0.48720682302771856
491,37045,2511,676,768,788,1835,2511,1.0,0.26921545201115094,0.7307845479888491,955,0.3058542413381123,0.3138191955396257,0.38032656312226204
492,37045,2967,765,857,1033,2202,2967,1.0,0.25783619817997977,0.7421638018200202,1077,0.28884395011796427,0.34816312773845637,0.36299292214357937
493,37045,3536,1116,1102,877,2420,3536,1.0,0.3156108597285068,0.6843891402714932,1557,0.31165158371040724,0.24802036199095023,0.4403280542986425
494,37045,1735,419,474,475,1316,1735,1.0,0.2414985590778098,0.7585014409221902,786,0.27319884726224786,0.2737752161383285,0.45302593659942364
495,37045,2587,557,611,773,2030,2587,1.0,0.21530730575956705,0.784692694240433,1203,0.23618090452261306,0.29880170081175106,0.46501739466563585
496,37045,1847,63,191,832,1784,1847,1.0,0.03410936654033568,0.9658906334596643,824,0.10341093665403357,0.4504602057390363,0.44612885760693016
497,37045,924,485,486,222,439,924,1.0,0.5248917748917749,0.4751082251082251,216,0.525974025974026,0.24025974025974026,0.23376623376623376
498,37045,2483,1050,1071,614,1433,2483,1.0,0.42287555376560615,0.5771244462343939,798,0.43133306484091827,0.24728151429722112,0.32138542086186067
499,37045,2211,1049,893,469,1162,2211,1.0,0.47444595205789236,0.5255540479421077,849,0.40388964269561284,0.21212121212121213,0.383989145183175
500,37045,3861,212,518,1565,3649,3861,1.0,0.05490805490805491,0.945091945091945,1778,0.13416213416213416,0.40533540533540535,0.4605024605024605
501,37045,4375,841,881,1400,3534,4375,1.0,0.19222857142857142,0.8077714285714286,2094,0.20137142857142856,0.32,0.4786285714285714
502,37045,3356,896,995,1252,2460,3356,1.0,0.266984505363528,0.733015494636472,1109,0.2964839094159714,0.3730631704410012,0.3304529201430274
503,37045,1727,146,241,715,1581,1727,1.0,0.08453966415749856,0.9154603358425014,771,0.13954834973943253,0.4140127388535032,0.44643891140706427
504,37045,2965,469,602,1216,2496,2965,1.0,0.1581787521079258,0.8418212478920742,1147,0.203035413153457,0.4101180438448567,0.38684654300168636
505,37045,822,43,125,319,779,822,1.0,0.052311435523114354,0.9476885644768857,378,0.15206812652068127,0.3880778588807786,0.45985401459854014
506,37045,2209,828,726,448,1381,2209,1.0,0.37483023992756903,0.625169760072431,1035,0.32865550022634676,0.20280669986419195,0.4685377999094613
507,37045,1957,191,320,812,1766,1957,1.0,0.0975983648441492,0.9024016351558508,825,0.16351558507920286,0.41492079713847724,0.4215636177823199
508,37045,2872,564,618,972,2308,2872,1.0,0.19637883008356546,0.8036211699164345,1282,0.21518105849582173,0.3384401114206128,0.44637883008356544
509,37047,1129,254,251,493,875,1129,1.0,0.224977856510186,0.775022143489814,385,0.22232063773250665,0.4366696191319752,0.3410097431355182
510,37047,1367,659,566,263,708,1367,1.0,0.4820775420629115,0.5179224579370885,538,0.4140453547915143,0.19239209948792976,0.393562545720556
511,37047,1677,234,414,451,1443,1677,1.0,0.13953488372093023,0.8604651162790697,812,0.24686940966010734,0.2689326177698271,0.4841979725700656
512,37047,2138,565,625,715,1573,2138,1.0,0.26426566884939195,0.735734331150608,798,0.2923292797006548,0.3344246959775491,0.37324602432179604
513,37047,1107,214,200,366,893,1107,1.0,0.1933152664859982,0.8066847335140018,541,0.18066847335140018,0.33062330623306235,0.48870822041553746
514,37047,521,14,41,198,507,521,1.0,0.026871401151631478,0.9731285988483686,282,0.07869481765834933,0.3800383877159309,0.5412667946257198
515,37047,2218,206,160,998,2012,2218,1.0,0.09287646528403967,0.9071235347159603,1060,0.0721370604147881,0.4499549143372408,0.47790802524797116
516,37047,5287,2402,1012,959,2885,5287,1.0,0.4543219216947229,0.5456780783052771,3316,0.19141289956497068,0.1813883109513902,0.6271987894836392
517,37047,2972,1001,848,806,1971,2972,1.0,0.33681022880215344,0.6631897711978466,1318,0.2853297442799462,0.2711978465679677,0.44347240915208613
518,37047,1693,512,132,432,1181,1693,1.0,0.3024217365623154,0.6975782634376846,1129,0.07796810395747195,0.2551683402244536,0.6668635558180744
519,37047,824,46,80,302,778,824,1.0,0.055825242718446605,0.9441747572815534,442,0.0970873786407767,0.36650485436893204,0.5364077669902912
520,37047,500,41,79,192,459,500,1.0,0.082,0.918,229,0.158,0.384,0.458
521,37047,985,15,90,417,970,985,1.0,0.015228426395939087,0.9847715736040609,478,0.09137055837563451,0.4233502538071066,0.4852791878172589
522,37047,517,204,112,129,313,517,1.0,0.3945841392649903,0.6054158607350096,276,0.21663442940038685,0.2495164410058027,0.5338491295938105
523,37047,793,112,109,237,681,793,1.0,0.14123581336696092,0.8587641866330391,447,0.13745271122320302,0.2988650693568726,0.5636822194199244
524,37047,2533,922,792,697,1611,2533,1.0,0.363995262534544,0.6360047374654559,1044,0.31267272009474933,0.2751677852348993,0.41215949467035135
525,37047,1403,579,469,355,824,1403,1.0,0.4126870990734141,0.5873129009265858,579,0.33428367783321455,0.25302922309337134,0.4126870990734141
526,37047,1218,595,435,178,623,1218,1.0,0.4885057471264368,0.5114942528735632,605,0.35714285714285715,0.14614121510673234,0.4967159277504105
527,37047,2534,538,531,838,1996,2534,1.0,0.2123125493291239,0.7876874506708761,1165,0.2095501183898974,0.3307024467245462,0.4597474348855564
528,37047,3648,1445,1220,859,2203,3648,1.0,0.39610745614035087,0.6038925438596491,1569,0.3344298245614035,0.23547149122807018,0.4300986842105263
529,37047,636,192,148,190,444,636,1.0,0.3018867924528302,0.6981132075471698,298,0.23270440251572327,0.29874213836477986,0.46855345911949686
530,37047,2216,775,749,745,1441,2216,1.0,0.3497292418772563,0.6502707581227437,722,0.3379963898916967,0.3361913357400722,0.32581227436823107
531,37047,3605,1220,1177,1093,2385,3605,1.0,0.33841886269070737,0.6615811373092927,1335,0.3264909847434119,0.3031900138696255,0.37031900138696255
532,37047,1569,68,151,687,1501,1569,1.0,0.043339706819630335,0.9566602931803697,731,0.09623964308476737,0.4378585086042065,0.46590184831102616
533,37047,1204,492,616,215,712,1204,1.0,0.40863787375415284,0.5913621262458472,373,0.5116279069767442,0.17857142857142858,0.30980066445182725
534,37047,272,3,43,126,269,272,1.0,0.011029411764705883,0.9889705882352942,103,0.15808823529411764,0.4632352941176471,0.3786764705882353
535,37049,559,20,60,324,539,559,1.0,0.03577817531305903,0.964221824686941,175,0.1073345259391771,0.5796064400715564,0.31305903398926654
536,37049,2240,195,469,1341,2045,2240,1.0,0.08705357142857142,0.9129464285714286,430,0.209375,0.5986607142857143,0.19196428571428573
537,37049,1130,313,246,394,817,1130,1.0,0.27699115044247785,0.7230088495575221,490,0.2176991150442478,0.3486725663716814,0.4336283185840708
538,37049,634,271,221,205,363,634,1.0,0.4274447949526814,0.5725552050473186,208,0.34858044164037855,0.32334384858044163,0.3280757097791798
539,37049,1060,273,228,367,787,1060,1.0,0.25754716981132075,0.7424528301886792,465,0.21509433962264152,0.3462264150943396,0.4386792452830189
540,37049,851,92,135,392,759,851,1.0,0.10810810810810811,0.8918918918918919,324,0.15863689776733256,0.4606345475910693,0.3807285546415981
541,37049,4655,1553,995,1320,3102,4655,1.0,0.33361976369495167,0.6663802363050484,2340,0.21374865735767992,0.28356605800214824,0.5026852846401718
542,37049,5124,1551,1641,1098,3573,5124,1.0,0.30269320843091335,0.6973067915690867,2385,0.3202576112412178,0.21428571428571427,0.46545667447306793
543,37049,2527,773,745,962,1754,2527,1.0,0.30589631974673526,0.6941036802532647,820,0.29481598733676295,0.3806885635140483,0.32449544914918876
544,37049,2688,1717,1447,364,971,2688,1.0,0.6387648809523809,0.36123511904761907,877,0.5383184523809523,0.13541666666666666,0.32626488095238093
545,37049,2699,208,654,1262,2491,2699,1.0,0.0770655798443868,0.9229344201556132,783,0.24231196739533162,0.46758058540200076,0.2901074472026677
546,37049,3148,110,723,1562,3038,3148,1.0,0.0349428208386277,0.9650571791613723,863,0.22966963151207115,0.49618805590851334,0.2741423125794155
547,37049,3299,54,669,2141,3245,3299,1.0,0.016368596544407397,0.9836314034555926,489,0.20278872385571386,0.6489845407699303,0.14822673537435588
548,37049,1395,493,349,310,902,1395,1.0,0.353405017921147,0.646594982078853,736,0.25017921146953404,0.2222222222222222,0.5275985663082438
549,37049,889,268,362,414,621,889,1.0,0.3014623172103487,0.6985376827896513,113,0.40719910011248595,0.46569178852643417,0.12710911136107986
550,37049,983,328,334,406,655,983,1.0,0.3336724313326551,0.6663275686673449,243,0.3397761953204476,0.41302136317395727,0.24720244150559512
551,37049,2648,1157,970,587,1491,2648,1.0,0.4369335347432024,0.5630664652567976,1091,0.36631419939577037,0.22167673716012085,0.41200906344410876
552,37049,4276,542,990,2052,3734,4276,1.0,0.12675397567820393,0.8732460243217961,1234,0.2315247895229186,0.47988774555659497,0.2885874649204864
553,37049,2177,449,643,698,1728,2177,1.0,0.20624712907671108,0.793752870923289,836,0.29536058796508957,0.3206247129076711,0.38401469912723935
554,37049,2225,174,322,1132,2051,2225,1.0,0.07820224719101124,0.9217977528089888,771,0.1447191011235955,0.5087640449438202,0.34651685393258425
555,37049,2417,1092,931,372,1325,2417,1.0,0.45179975175837817,0.5482002482416218,1114,0.38518824989656597,0.1539098055440629,0.4609019445593711
556,37049,2897,1110,1082,927,1787,2897,1.0,0.3831549879185364,0.6168450120814636,888,0.37348981705212286,0.319986192613048,0.30652399033482913
557,37049,10395,1198,868,1741,9197,10395,1.0,0.11524771524771525,0.8847522847522847,7786,0.08350168350168351,0.16748436748436749,0.749013949013949
558,37049,3373,252,464,1387,3121,3373,1.0,0.07471093981618737,0.9252890601838126,1522,0.13756300029647198,0.4112066409724281,0.4512303587310999
559,37049,4787,694,1248,1869,4093,4787,1.0,0.1449759766033006,0.8550240233966994,1670,0.26070607896386044,0.39043242114058907,0.34886149989555043
560,37049,4175,445,756,1823,3730,4175,1.0,0.10658682634730539,0.8934131736526946,1596,0.18107784431137725,0.43664670658682636,0.3822754491017964
561,37049,6051,1314,1211,1478,4737,6051,1.0,0.21715418939018344,0.7828458106098165,3362,0.20013220955214014,0.24425714757891256,0.5556106428689472
562,37051,4441,739,995,1812,3702,4441,1.0,0.1664039630713803,0.8335960369286197,1634,0.22404863769421302,0.4080162125647377,0.3679351497410493
563,37051,7956,1391,1658,3175,6565,7956,1.0,0.17483660130718953,0.8251633986928104,3123,0.2083961789844143,0.39906988436400204,0.3925339366515837
564,37051,11325,2952,3161,3256,8373,11325,1.0,0.2606622516556291,0.7393377483443708,4908,0.2791169977924945,0.28750551876379693,0.43337748344370863
565,37051,1068,956,702,9,112,1068,1.0,0.8951310861423221,0.10486891385767791,357,0.6573033707865169,0.008426966292134831,0.3342696629213483
566,37051,2324,1766,1318,125,558,2324,1.0,0.7598967297762479,0.24010327022375216,881,0.5671256454388984,0.05378657487091222,0.3790877796901893
567,37051,1286,236,383,379,1050,1286,1.0,0.18351477449455678,0.8164852255054432,524,0.2978227060653188,0.29471228615863143,0.40746500777604977
568,37051,1311,224,325,703,1087,1311,1.0,0.17086193745232647,0.8291380625476735,283,0.2479023646071701,0.5362318840579711,0.21586575133485889
569,37051,1280,109,289,503,1171,1280,1.0,0.08515625,0.91484375,488,0.22578125,0.39296875,0.38125
570,37051,1400,635,485,315,765,1400,1.0,0.45357142857142857,0.5464285714285714,600,0.3464285714285714,0.225,0.42857142857142855
571,37051,3094,520,706,1136,2574,3094,1.0,0.16806722689075632,0.8319327731092437,1252,0.2281835811247576,0.36716224951519066,0.4046541693600517
572,37051,1594,77,280,988,1517,1594,1.0,0.04830614805520703,0.951693851944793,326,0.17565872020075282,0.6198243412797992,0.20451693851944794
573,37051,1931,1795,1582,22,136,1931,1.0,0.9295701708959089,0.07042982910409114,327,0.8192646297255308,0.011393060590367685,0.1693423096841015
574,37051,2887,2284,1696,54,603,2887,1.0,0.7911326636647038,0.20886733633529617,1137,0.5874610322133703,0.018704537582265326,0.39383443020436437
575,37051,1516,321,385,441,1195,1516,1.0,0.2117414248021108,0.7882585751978892,690,0.25395778364116095,0.29089709762532984,0.4551451187335092
576,37051,13019,3683,3895,3013,9336,13019,1.0,0.2828942315077963,0.7171057684922038,6111,0.2991781242798986,0.23143098548275598,0.4693908902373454
577,37051,6648,1917,1972,1467,4731,6648,1.0,0.28835740072202165,0.7116425992779783,3209,0.29663056558363415,0.22066787003610108,0.48270156438026474
578,37051,2410,598,743,610,1812,2410,1.0,0.24813278008298756,0.7518672199170124,1057,0.308298755186722,0.25311203319502074,0.43858921161825726
579,37051,1762,308,394,783,1454,1762,1.0,0.17480136208853575,0.8251986379114642,585,0.22360953461975028,0.4443813847900113,0.33200908059023837
580,37051,2273,359,560,885,1914,2273,1.0,0.15794104707435108,0.8420589529256489,828,0.24637043554773427,0.3893532776066872,0.36427628684557856
581,37051,14830,7675,6508,2125,7155,14830,1.0,0.5175320296695887,0.48246797033041133,6197,0.43884018880647335,0.1432906271072151,0.4178691840863115
582,37051,3235,1245,1050,438,1990,3235,1.0,0.3848531684698609,0.615146831530139,1747,0.32457496136012365,0.13539412673879445,0.5400309119010819
583,37051,1993,482,463,359,1511,1993,1.0,0.2418464626191671,0.7581535373808329,1171,0.23231309583542398,0.18013045659809332,0.5875564475664827
584,37051,2900,1367,1302,314,1533,2900,1.0,0.4713793103448276,0.5286206896551724,1284,0.4489655172413793,0.10827586206896551,0.44275862068965516
585,37051,4229,2091,1953,576,2138,4229,1.0,0.49444313076377394,0.505556869236226,1700,0.461811302908489,0.13620241191771104,0.4019862851738
586,37051,1831,898,732,141,933,1831,1.0,0.4904423812124522,0.5095576187875478,958,0.3997815401419989,0.07700709994538503,0.523211359912616
587,37051,2762,1133,1022,602,1629,2762,1.0,0.4102099927588704,0.5897900072411296,1138,0.37002172338884864,0.2179580014482259,0.41202027516292544
588,37051,1817,896,502,145,921,1817,1.0,0.49312052834342324,0.5068794716565768,1170,0.2762795817281233,0.07980187121629059,0.6439185470555862
589,37051,2563,745,687,488,1818,2563,1.0,0.2906749902458057,0.7093250097541943,1388,0.2680452594615685,0.1904018728053063,0.5415528677331253
590,37051,2735,496,499,1221,2239,2735,1.0,0.1813528336380256,0.8186471663619744,1015,0.18244972577696528,0.4464351005484461,0.3711151736745887
591,37051,4174,2049,1689,591,2125,4174,1.0,0.49089602299952084,0.5091039770004792,1894,0.40464781983708675,0.14159080019166267,0.4537613799712506
592,37051,3326,729,743,1240,2597,3326,1.0,0.21918220084185208,0.780817799158148,1343,0.22339146121467227,0.3728202044497895,0.4037883343355382
593,37051,6581,2296,2216,1960,4285,6581,1.0,0.3488831484576812,0.6511168515423188,2405,0.3367269411943474,0.29782707795167906,0.36544598085397356
594,37051,2434,535,640,925,1899,2434,1.0,0.2198027937551356,0.7801972062448644,869,0.2629416598192276,0.3800328677074774,0.35702547247329497
595,37051,3545,1236,1183,569,2309,3545,1.0,0.34866008462623416,0.6513399153737659,1793,0.33370944992947815,0.16050775740479548,0.5057827926657263
596,37051,10755,3597,3233,2006,7158,10755,1.0,0.33444909344490936,0.6655509065550906,5516,0.300604370060437,0.18651789865178986,0.5128777312877731
597,37051,5889,2385,1826,469,3504,5889,1.0,0.40499235863474276,0.5950076413652573,3594,0.31006962132789945,0.07964000679232468,0.6102903718797759
598,37051,3514,656,776,1359,2858,3514,1.0,0.186681844052362,0.813318155947638,1379,0.22083096186681844,0.3867387592487194,0.39243027888446214
599,37051,21761,5261,3514,1369,16500,21761,1.0,0.24176278663664352,0.7582372133633565,16878,0.1614815495611415,0.06291071182390515,0.7756077386149534
600,37051,4571,1855,1672,531,2716,4571,1.0,0.4058192955589586,0.5941807044410413,2368,0.365784292277401,0.11616714066943776,0.5180485670531613
601,37051,2874,2190,1656,176,684,2874,1.0,0.7620041753653445,0.23799582463465555,1042,0.5762004175365344,0.061238691718858734,0.36256089074460685
602,37051,2622,1851,1369,163,771,2622,1.0,0.7059496567505721,0.2940503432494279,1090,0.5221205186880244,0.062166285278413426,0.41571319603356216
603,37051,6234,3036,2960,916,3198,6234,1.0,0.4870067372473532,0.5129932627526468,2358,0.4748155277510427,0.14693615656079564,0.3782483156881617
604,37051,25793,10419,9734,5356,15374,25793,1.0,0.4039468072732912,0.5960531927267088,10703,0.37738921412786414,0.20765323925095958,0.4149575466211763
605,37051,2706,854,810,511,1852,2706,1.0,0.3155949741315595,0.6844050258684405,1385,0.29933481152993346,0.18883961566888396,0.5118255728011826
606,37051,1990,594,574,780,1396,1990,1.0,0.2984924623115578,0.7015075376884422,636,0.2884422110552764,0.39195979899497485,0.31959798994974875
607,37051,2815,559,655,1326,2256,2815,1.0,0.1985790408525755,0.8014209591474245,834,0.23268206039076378,0.47104795737122557,0.29626998223801065
608,37051,10011,1963,2781,3717,8048,10011,1.0,0.1960843072620118,0.8039156927379882,3513,0.2777944261312556,0.3712915792628109,0.3509139946059335
609,37051,3875,1738,1514,617,2137,3875,1.0,0.44851612903225807,0.551483870967742,1744,0.39070967741935486,0.1592258064516129,0.45006451612903225
610,37053,372,0,54,139,372,372,1.0,0.0,1.0,179,0.14516129032258066,0.3736559139784946,0.48118279569892475
611,37053,1730,134,401,603,1596,1730,1.0,0.07745664739884393,0.922543352601156,726,0.23179190751445086,0.3485549132947977,0.41965317919075146
612,37053,430,9,158,253,421,430,1.0,0.020930232558139535,0.9790697674418605,19,0.3674418604651163,0.5883720930232558,0.044186046511627906
613,37053,245,0,57,129,245,245,1.0,0.0,1.0,59,0.23265306122448978,0.5265306122448979,0.24081632653061225
614,37053,977,136,167,233,841,977,1.0,0.13920163766632548,0.8607983623336745,577,0.17093142272262027,0.23848515864892528,0.5905834186284544
615,37053,1217,3,174,438,1214,1217,1.0,0.0024650780608052587,0.9975349219391948,605,0.142974527526705,0.3599013968775678,0.4971240755957272
616,37053,3424,107,623,1570,3317,3424,1.0,0.03125,0.96875,1231,0.18195093457943926,0.45852803738317754,0.3595210280373832
617,37053,3800,175,794,1363,3625,3800,1.0,0.046052631578947366,0.9539473684210527,1643,0.20894736842105263,0.35868421052631577,0.43236842105263157
618,37053,131,0,61,70,131,131,1.5411764705882354,0.0,1.0,0,0.46564885496183206,0.5343511450381679,0.0
619,37053,1061,126,235,521,935,1061,1.0,0.11875589066918002,0.88124410933082,305,0.22148916116870876,0.49104618284637136,0.2874646559849199
620,37053,4615,356,838,2177,4259,4615,1.0,0.0771397616468039,0.9228602383531961,1600,0.18158179848320694,0.4717226435536295,0.3466955579631636
621,37055,2660,26,777,1089,2634,2660,1.0,0.009774436090225564,0.9902255639097745,794,0.29210526315789476,0.4093984962406015,0.29849624060150376
622,37055,330,0,157,173,330,330,1.0030395136778116,0.0,1.0,0,0.47575757575757577,0.5242424242424243,0.0
623,37055,5320,56,1381,1630,5264,5320,1.0,0.010526315789473684,0.9894736842105263,2309,0.25958646616541353,0.30639097744360905,0.4340225563909774
624,37055,125,1,13,32,124,125,1.0,0.008,0.992,80,0.104,0.256,0.64
625,37055,180,0,28,71,180,180,1.0,0.0,1.0,81,0.15555555555555556,0.39444444444444443,0.45
626,37055,518,5,174,152,513,518,1.0,0.009652509652509652,0.9903474903474904,192,0.3359073359073359,0.29343629343629346,0.37065637065637064
627,37055,675,4,112,243,671,675,1.0,0.005925925925925926,0.9940740740740741,320,0.16592592592592592,0.36,0.4740740740740741
628,37055,2708,8,870,1463,2700,2708,1.0,0.0029542097488921715,0.9970457902511078,375,0.3212703101920236,0.5402511078286558,0.13847858197932053
629,37055,3247,18,883,1081,3229,3247,1.0,0.00554357868801971,0.9944564213119803,1283,0.27194333230674467,0.3329226978749615,0.3951339698182938
630,37055,4748,445,1382,1676,4303,4748,1.0,0.09372367312552654,0.9062763268744735,1690,0.2910699241786015,0.35299073294018535,0.35593934288121315
631,37055,2320,35,679,908,2285,2320,1.0,0.015086206896551725,0.9849137931034483,733,0.29267241379310344,0.3913793103448276,0.315948275862069
632,37055,672,1,201,237,671,672,1.0,0.001488095238095238,0.9985119047619048,234,0.29910714285714285,0.35267857142857145,0.3482142857142857
633,37055,424,1,107,241,423,424,1.0,0.0023584905660377358,0.9976415094339622,76,0.25235849056603776,0.5683962264150944,0.1792452830188679
634,37055,742,0,168,298,742,742,1.0,0.0,1.0,276,0.22641509433962265,0.40161725067385445,0.3719676549865229
635,37055,1187,7,278,440,1180,1187,1.0,0.005897219882055603,0.9941027801179444,469,0.2342038753159225,0.37068239258635216,0.3951137320977254
636,37055,1273,3,183,514,1270,1273,1.0,0.002356637863315004,0.997643362136685,576,0.14375490966221524,0.40377062058130403,0.45247446975648076
637,37057,6131,592,1103,2935,5539,6131,1.0,0.09655847333224596,0.903441526667754,2093,0.1799053987930191,0.47871472842929375,0.34137987277768717
638,37057,3872,40,407,1712,3832,3872,1.0,0.010330578512396695,0.9896694214876033,1753,0.10511363636363637,0.44214876033057854,0.4527376033057851
639,37057,2932,167,487,1097,2765,2932,1.0,0.05695770804911323,0.9430422919508867,1348,0.1660982264665757,0.3741473396998636,0.4597544338335607
640,37057,2925,71,364,1279,2854,2925,1.0,0.024273504273504273,0.9757264957264957,1282,0.12444444444444444,0.4372649572649573,0.4382905982905983
641,37057,5202,664,969,1811,4538,5202,1.0,0.12764321414840446,0.8723567858515956,2422,0.18627450980392157,0.3481353325643983,0.4655901576316801
642,37057,4671,46,654,2124,4625,4671,1.0,0.009847998287304646,0.9901520017126954,1893,0.14001284521515736,0.45472061657032753,0.4052665382145151
643,37057,2564,510,702,679,2054,2564,1.0,0.19890795631825273,0.8010920436817472,1183,0.27379095163806555,0.26482059282371295,0.46138845553822155
644,37057,2833,154,472,1108,2679,2833,1.0,0.05435933639251676,0.9456406636074832,1253,0.1666078362160254,0.39110483586304273,0.4422873279209319
645,37057,2539,90,308,1309,2449,2539,1.0,0.035447026388341865,0.9645529736116581,922,0.12130760141788105,0.5155573060259945,0.3631350925561245
646,37057,3375,49,423,1742,3326,3375,1.0,0.01451851851851852,0.9854814814814815,1210,0.12533333333333332,0.5161481481481481,0.3585185185185185
647,37057,4234,32,510,2533,4202,4234,1.0,0.007557864903164856,0.9924421350968351,1191,0.1204534718941899,0.5982522437411432,0.28129428436466697
648,37057,3030,545,599,746,2485,3030,1.0,0.17986798679867988,0.8201320132013201,1685,0.1976897689768977,0.2462046204620462,0.5561056105610561
649,37057,2661,46,307,1443,2615,2661,1.0,0.01728673431040962,0.9827132656895904,911,0.11537016159338595,0.5422773393461104,0.3423524990605036
650,37057,1411,56,148,432,1355,1411,1.0,0.039688164422395464,0.9603118355776046,831,0.10489014883061658,0.30616583982990786,0.5889440113394756
651,37057,4456,72,499,2104,4384,4456,1.0,0.01615798922800718,0.9838420107719928,1853,0.111983842010772,0.47217235188509876,0.41584380610412924
652,37057,1777,368,494,319,1409,1777,1.0,0.20709060213843555,0.7929093978615644,964,0.2779966235227912,0.1795160382667417,0.5424873382104671
653,37057,3591,53,388,1716,3538,3591,1.0,0.014759120022277916,0.985240879977722,1487,0.10804789752158173,0.4778613199665831,0.4140907825118351
654,37057,920,49,169,400,871,920,1.0,0.05326086956521739,0.9467391304347826,351,0.18369565217391304,0.43478260869565216,0.3815217391304348
655,37057,5138,250,877,2849,4888,5138,1.0,0.04865706500583885,0.9513429349941611,1412,0.1706889840404827,0.5544959128065395,0.2748151031529778
656,37057,3023,52,416,1316,2971,3023,1.0,0.017201455507773734,0.9827985444922263,1291,0.13761164406218987,0.43532914323519684,0.4270592127026133
657,37057,1688,64,239,565,1624,1688,1.0,0.037914691943127965,0.9620853080568721,884,0.1415876777251185,0.3347156398104265,0.523696682464455
658,37057,2642,1363,1218,182,1279,2642,1.0,0.5158970476911431,0.4841029523088569,1242,0.4610143830431491,0.06888720666161999,0.47009841029523086
659,37057,2581,340,451,597,2241,2581,1.0,0.13173188686555598,0.868268113134444,1533,0.17473847345989926,0.2313056954668733,0.5939558310732275
660,37057,1097,1,162,400,1096,1097,1.0,0.0009115770282588879,0.9990884229717412,535,0.14767547857793983,0.3646308113035551,0.487693710118505
661,37057,2274,4,143,929,2270,2274,1.0,0.001759014951627089,0.9982409850483729,1202,0.06288478452066842,0.40853122251539137,0.5285839929639402
662,37057,2801,112,400,1355,2689,2801,1.0,0.039985719385933594,0.9600142806140664,1046,0.14280614066404856,0.48375580149946446,0.373438057836487
663,37057,3577,152,530,1306,3425,3577,1.0,0.0424937098126922,0.9575062901873078,1741,0.14816885658372939,0.36511042773273694,0.4867207156835337
664,37057,1279,57,245,497,1222,1279,1.0,0.044566067240031274,0.9554339327599687,537,0.19155590304925724,0.3885848318999218,0.41985926505082094
665,37057,2358,342,582,477,2016,2358,1.0,0.1450381679389313,0.8549618320610687,1299,0.24681933842239187,0.20229007633587787,0.5508905852417303
666,37057,3011,18,208,1291,2993,3011,1.0,0.005978080371969445,0.9940219196280305,1512,0.06908003985386915,0.42876120890069747,0.5021587512454334
667,37057,3065,23,362,1388,3042,3065,1.0,0.007504078303425775,0.9924959216965742,1315,0.11810766721044046,0.45285481239804243,0.4290375203915171
668,37057,2108,7,245,972,2101,2108,1.0,0.003320683111954459,0.9966793168880456,891,0.11622390891840607,0.46110056925996207,0.42267552182163187
669,37057,4601,188,739,2380,4413,4601,1.0,0.04086068246033471,0.9591393175396653,1482,0.16061725711801783,0.5172788524233862,0.32210389045859594
670,37057,3794,103,521,1548,3691,3794,1.0,0.027148128624143383,0.9728518713758566,1725,0.13732208750658936,0.408012651555087,0.45466526093832366
671,37057,3538,62,388,1266,3476,3538,1.0,0.017524024872809497,0.9824759751271905,1884,0.10966647823629169,0.3578292820802713,0.532504239683437
672,37057,4007,465,817,2111,3542,4007,1.0,0.11604691789368606,0.883953082106314,1079,0.20389318692288494,0.5268280509109059,0.2692787621662091
673,37057,2307,881,702,265,1426,2307,1.0,0.3818812310359775,0.6181187689640225,1340,0.30429128738621586,0.11486779367143476,0.5808409189423493
674,37057,1955,404,450,294,1551,1955,1.0,0.20664961636828644,0.7933503836317135,1211,0.23017902813299232,0.15038363171355498,0.6194373401534526
675,37057,1404,1,141,625,1403,1404,1.0,0.0007122507122507123,0.9992877492877493,638,0.10042735042735043,0.44515669515669515,0.4544159544159544
676,37057,2227,1114,944,209,1113,2227,1.0,0.5002245172878311,0.4997754827121688,1074,0.42388863942523575,0.09384822631342614,0.4822631342613381
677,37057,2150,922,657,124,1228,2150,1.0,0.4288372093023256,0.5711627906976744,1369,0.3055813953488372,0.05767441860465116,0.6367441860465116
678,37057,2257,5,184,948,2252,2257,1.0,0.002215330084182543,0.9977846699158175,1125,0.0815241470979176,0.42002658396101017,0.4984492689410722
679,37059,1107,142,216,525,965,1107,1.0,0.12827461607949414,0.8717253839205059,366,0.1951219512195122,0.4742547425474255,0.33062330623306235
680,37059,1335,67,200,505,1268,1335,1.0,0.050187265917602995,0.949812734082397,630,0.149812734082397,0.3782771535580524,0.47191011235955055
681,37059,2859,105,416,1306,2754,2859,1.0,0.03672612801678909,0.9632738719832109,1137,0.14550542147604056,0.4568030779993005,0.39769150052465896
682,37059,2520,233,404,729,2287,2520,1.0,0.09246031746031746,0.9075396825396825,1387,0.16031746031746033,0.2892857142857143,0.5503968253968254
683,37059,2562,105,352,1427,2457,2562,1.0,0.040983606557377046,0.9590163934426229,783,0.13739266198282593,0.5569867291178766,0.30562060889929743
684,37059,1783,95,319,828,1688,1783,1.0,0.0532809871003926,0.9467190128996074,636,0.17891194615816042,0.464385866517106,0.3567021873247336
685,37059,2020,176,362,805,1844,2020,1.0,0.08712871287128712,0.9128712871287129,853,0.1792079207920792,0.39851485148514854,0.42227722772277226
686,37059,2321,411,682,697,1910,2321,1.0,0.17707884532529083,0.8229211546747092,942,0.2938388625592417,0.3003015941404567,0.4058595433003016
687,37059,2633,287,531,974,2346,2633,1.0,0.10900113938473224,0.8909988606152678,1128,0.20167109760729207,0.3699202430687429,0.42840865932396505
688,37059,2179,39,406,1246,2140,2179,1.0,0.017898118402937126,0.9821018815970629,527,0.18632400183570444,0.5718219366681965,0.24185406149609912
689,37059,1787,29,221,966,1758,1787,1.0,0.016228315612758813,0.9837716843872412,600,0.12367095691102406,0.540570789031897,0.33575825405707893
690,37059,3458,129,643,1964,3329,3458,1.0,0.0373048004626952,0.9626951995373048,851,0.18594563331405436,0.5679583574320416,0.24609600925390399
691,37059,2837,79,561,1681,2758,2837,1.0,0.02784631653154741,0.9721536834684525,595,0.19774409587592529,0.5925273175890025,0.20972858653507226
692,37059,2088,100,422,1034,1988,2088,1.0,0.04789272030651341,0.9521072796934866,632,0.2021072796934866,0.4952107279693487,0.30268199233716475
693,37061,3596,363,602,1255,3233,3596,1.0,0.10094549499443826,0.8990545050055617,1739,0.16740823136818686,0.34899888765294773,0.4835928809788654
694,37061,1658,422,363,482,1236,1658,1.0,0.2545235223160434,0.7454764776839565,813,0.2189384800965018,0.29071170084439085,0.49034981905910735
695,37061,1701,828,648,287,873,1701,1.0,0.48677248677248675,0.5132275132275133,766,0.38095238095238093,0.16872427983539096,0.4503233392122281
696,37061,912,28,58,369,884,912,1.0,0.03070175438596491,0.9692982456140351,485,0.06359649122807018,0.40460526315789475,0.5317982456140351
697,37061,4303,1723,1260,937,2580,4303,1.0,0.40041831280501977,0.5995816871949803,2106,0.2928189635138276,0.21775505461306066,0.48942598187311176
698,37061,1214,424,262,357,790,1214,1.0,0.34925864909390447,0.6507413509060955,595,0.2158154859967051,0.2940691927512356,0.4901153212520593
699,37061,1544,161,192,704,1383,1544,1.0,0.10427461139896373,0.8957253886010362,648,0.12435233160621761,0.45595854922279794,0.41968911917098445
700,37061,2298,701,426,535,1597,2298,1.0,0.3050478677110531,0.6949521322889469,1337,0.185378590078329,0.2328111401218451,0.581810269799826
701,37061,4543,2183,1498,740,2360,4543,1.0,0.4805194805194805,0.5194805194805194,2305,0.32973805855161786,0.16288795949812898,0.5073739819502532
702,37061,5837,1770,1497,1500,4067,5837,1.0,0.3032379647078979,0.6967620352921021,2840,0.256467363371595,0.25698132602364226,0.4865513106047627
703,37061,1093,191,153,448,902,1093,1.0,0.1747483989021043,0.8252516010978957,492,0.13998170173833485,0.40988106129917656,0.4501372369624886
704,37061,2179,702,574,323,1477,2179,1.0,0.3221661312528683,0.6778338687471317,1282,0.26342358880220285,0.14823313446535108,0.5883432767324461
705,37061,2570,137,218,561,2433,2570,1.0,0.05330739299610895,0.946692607003891,1791,0.08482490272373541,0.21828793774319066,0.6968871595330739
706,37061,651,80,63,224,571,651,1.0,0.1228878648233487,0.8771121351766513,364,0.0967741935483871,0.34408602150537637,0.5591397849462365
707,37061,1236,222,168,430,1014,1236,1.0,0.1796116504854369,0.8203883495145631,638,0.13592233009708737,0.3478964401294498,0.5161812297734628
708,37061,2546,839,525,640,1707,2546,1.0,0.32953652788688137,0.6704634721131186,1381,0.20620581304006286,0.2513747054202671,0.5424194815396701
709,37061,1538,227,179,589,1311,1538,1.0,0.14759427828348504,0.852405721716515,770,0.11638491547464239,0.38296488946684004,0.5006501950585176
710,37061,1258,68,78,343,1190,1258,1.0,0.05405405405405406,0.9459459459459459,837,0.06200317965023847,0.2726550079491256,0.665341812400636
711,37061,2958,171,251,681,2787,2958,1.0,0.057809330628803245,0.9421906693711968,2026,0.08485463150777553,0.2302231237322515,0.684922244759973
712,37063,6814,2538,3382,1024,4276,6814,1.0,0.3724684473143528,0.6275315526856472,2408,0.4963310830642794,0.15027883768711475,0.3533900792486058
713,37063,1952,1623,1562,29,329,1952,1.0,0.8314549180327869,0.16854508196721313,361,0.8002049180327869,0.01485655737704918,0.18493852459016394
714,37063,7323,1976,4468,1704,5347,7323,1.0,0.26983476717192406,0.7301652328280759,1151,0.6101324593745733,0.23269151986890618,0.15717602075652054
715,37063,3559,1787,1467,56,1772,3559,1.0,0.5021073335206518,0.49789266647934816,2036,0.4121944366395055,0.015734756954200617,0.5720708064062939
716,37063,4069,2654,2347,283,1415,4069,1.0,0.652248709756697,0.34775129024330304,1439,0.5768001966085033,0.06955025804866061,0.3536495453428361
717,37063,1841,529,1072,375,1312,1841,1.0,0.287343834872352,0.7126561651276481,394,0.5822922324823465,0.20369364475828355,0.2140141227593699
718,37063,4258,967,2155,281,3291,4258,1.0,0.22710192578675434,0.7728980742132456,1822,0.5061061531235321,0.06599342414279004,0.4279004227336778
719,37063,1460,215,477,668,1245,1460,1.0,0.14726027397260275,0.8527397260273972,315,0.3267123287671233,0.4575342465753425,0.21575342465753425
720,37063,8984,2107,3288,494,6877,8984,1.0,0.2345280498664292,0.7654719501335708,5202,0.3659839715048976,0.054986642920747994,0.5790293855743545
721,37063,4587,1616,1950,1094,2971,4587,1.0,0.3522999781992588,0.6477000218007413,1543,0.4251144538914323,0.23850010900370613,0.3363854371048616
722,37063,2576,238,937,985,2338,2576,1.0,0.09239130434782608,0.907608695652174,654,0.36374223602484473,0.3823757763975155,0.25388198757763975
723,37063,6595,4023,4448,777,2572,6595,1.0,0.6100075815011372,0.3899924184988628,1370,0.6744503411675512,0.11781652767247915,0.20773313115996966
724,37063,2156,1180,1433,91,976,2156,1.0,0.5473098330241187,0.45269016697588127,632,0.6646567717996289,0.04220779220779221,0.29313543599257885
725,37063,2332,331,1363,210,2001,2332,1.0,0.14193825042881647,0.8580617495711835,759,0.5844768439108061,0.09005145797598628,0.32547169811320753
726,37063,3282,393,1269,1268,2889,3282,1.0,0.11974405850091407,0.8802559414990859,745,0.386654478976234,0.3863497867154174,0.22699573430834857
727,37063,5158,1041,2388,1677,4117,5158,1.0,0.20182241178751453,0.7981775882124854,1093,0.46297014346645987,0.3251260178363707,0.21190383869716944
728,37063,7430,1777,3203,873,5653,7430,1.0,0.23916554508748317,0.7608344549125168,3354,0.4310901749663526,0.11749663526244952,0.4514131897711978
729,37063,5086,707,2305,1469,4379,5086,1.0,0.13900904443570586,0.8609909555642942,1312,0.4532048761305545,0.28883208808493904,0.25796303578450647
730,37063,3261,2233,1884,49,1028,3261,1.0,0.6847592762956148,0.31524072370438516,1328,0.577736890524379,0.015026065624041705,0.4072370438515793
731,37063,5788,3675,3768,592,2113,5788,1.0,0.6349343469246718,0.3650656530753283,1428,0.6510020732550104,0.1022805805114029,0.24671734623358674
732,37063,5760,1073,2885,2028,4687,5760,1.0,0.18628472222222223,0.8137152777777777,847,0.5008680555555556,0.35208333333333336,0.14704861111111112
733,37063,3313,1823,1927,255,1490,3313,1.0,0.5502565650467854,0.4497434349532146,1131,0.5816480531240568,0.07696951403561726,0.341382432840326
734,37063,2544,514,1192,206,2030,2544,1.0,0.20204402515723272,0.7979559748427673,1146,0.46855345911949686,0.0809748427672956,0.45047169811320753
735,37063,4923,1894,1966,495,3029,4923,1.0,0.3847247613243957,0.6152752386756043,2462,0.3993499898435913,0.10054844606946983,0.5001015640869388
736,37063,4037,1012,1879,1088,3025,4037,1.0,0.2506811989100817,0.7493188010899182,1070,0.4654446371067624,0.26950705969779537,0.26504830319544215
737,37063,5830,418,3194,1474,5412,5830,1.0,0.07169811320754717,0.9283018867924528,1162,0.5478559176672384,0.2528301886792453,0.1993138936535163
738,37063,2870,503,1799,1070,2367,2870,1.0105671010919337,0.17526132404181186,0.8247386759581882,1,0.6268292682926829,0.37282229965156793,0.0003484320557491289
739,37063,3886,432,1816,928,3454,3886,1.0,0.11116829644879053,0.8888317035512094,1142,0.46731857951621203,0.23880597014925373,0.2938754503345342
740,37063,5377,3739,3474,222,1638,5377,1.0,0.6953691649618746,0.3046308350381253,1681,0.6460851776083317,0.04128696299051516,0.31262785940115306
741,37063,1343,1190,976,14,153,1343,1.0,0.8860759493670886,0.11392405063291139,353,0.7267311988086373,0.010424422933730455,0.2628443782576322
742,37063,3912,811,1777,927,3101,3912,1.0,0.20731083844580778,0.7926891615541922,1208,0.4542433537832311,0.23696319018404907,0.30879345603271985
743,37063,3928,1086,1658,436,2842,3928,1.0,0.27647657841140527,0.7235234215885947,1834,0.42209775967413443,0.1109979633401222,0.4669042769857434
744,37063,3380,477,1196,1498,2903,3380,1.0,0.1411242603550296,0.8588757396449704,686,0.35384615384615387,0.44319526627218936,0.2029585798816568
745,37063,8679,4902,5512,961,3777,8679,1.0,0.564811614241272,0.435188385758728,2206,0.635096209240696,0.11072704228597764,0.25417674847332644
746,37063,2516,877,1741,352,1639,2516,1.0,0.3485691573926868,0.6514308426073132,423,0.6919713831478538,0.13990461049284578,0.16812400635930047
747,37063,2030,141,1173,201,1889,2030,1.0,0.06945812807881774,0.9305418719211823,656,0.5778325123152709,0.09901477832512315,0.32315270935960594
748,37063,1425,87,1001,222,1338,1425,1.0,0.061052631578947365,0.9389473684210526,202,0.7024561403508772,0.15578947368421053,0.14175438596491227
749,37063,1650,1361,777,13,289,1650,1.0,0.8248484848484848,0.17515151515151514,860,0.4709090909090909,0.00787878787878788,0.5212121212121212
750,37063,2054,506,1160,235,1548,2054,1.0,0.24634858812074,0.75365141187926,659,0.5647517039922103,0.11441090555014606,0.32083739045764365
751,37063,2493,562,1296,136,1931,2493,1.0,0.22543120738066585,0.7745687926193341,1061,0.51985559566787,0.05455274769354192,0.42559165663858806
752,37063,1808,553,815,95,1255,1808,1.0,0.30586283185840707,0.6941371681415929,898,0.45077433628318586,0.05254424778761062,0.49668141592920356
753,37063,1900,1155,913,80,745,1900,1.0,0.6078947368421053,0.39210526315789473,907,0.4805263157894737,0.042105263157894736,0.47736842105263155
754,37063,2483,1530,1342,94,953,2483,1.0,0.6161900926298832,0.3838099073701168,1047,0.540475231574708,0.037857430527587596,0.4216673378977044
755,37063,4212,3869,3988,45,343,4212,1.0,0.9185660018993352,0.08143399810066476,179,0.9468186134852802,0.010683760683760684,0.04249762583095917
756,37063,1331,1220,1260,54,111,1331,1.0,0.9166040570999249,0.08339594290007513,17,0.946656649135988,0.0405709992486852,0.012772351615326822
757,37063,1288,1134,1068,24,154,1288,1.0,0.8804347826086957,0.11956521739130435,196,0.8291925465838509,0.018633540372670808,0.15217391304347827
758,37063,670,593,506,17,77,670,1.0,0.8850746268656716,0.11492537313432835,147,0.755223880597015,0.025373134328358207,0.21940298507462686
759,37063,2303,643,1227,427,1660,2303,1.0,0.27920104211897523,0.7207989578810248,649,0.532783326096396,0.18541033434650456,0.28180633955709944
760,37063,7495,2872,4115,1072,4623,7495,1.0,0.38318879252835225,0.6168112074716477,2308,0.5490326884589727,0.14302868579052702,0.30793862575050035
761,37063,2016,649,1388,200,1367,2016,1.0,0.3219246031746032,0.6780753968253969,428,0.6884920634920635,0.0992063492063492,0.2123015873015873
762,37063,2948,241,1579,738,2707,2948,1.0,0.08175033921302578,0.9182496607869742,631,0.5356173677069199,0.2503392130257802,0.21404341926729986
763,37063,4702,793,2925,1051,3909,4702,1.0,0.16865163760102084,0.8313483623989791,726,0.6220757124627818,0.22352190557209697,0.15440238196512124
764,37063,4070,1397,1666,1041,2673,4070,1.0,0.34324324324324323,0.6567567567567567,1363,0.4093366093366093,0.2557739557739558,0.3348894348894349
765,37063,6122,2281,3277,1311,3841,6122,1.0,0.3725906566481542,0.6274093433518458,1534,0.5352825873897419,0.21414570401829466,0.2505717085919634
766,37063,3488,708,1590,760,2780,3488,1.0,0.2029816513761468,0.7970183486238532,1138,0.455848623853211,0.21788990825688073,0.32626146788990823
767,37065,2753,1728,1105,263,1025,2753,1.0,0.6276788957500908,0.37232110424990916,1385,0.40138031238648747,0.0955321467490011,0.5030875408645115
768,37065,2774,2346,1876,131,428,2774,1.0,0.8457101658255227,0.15428983417447728,767,0.6762797404470079,0.04722422494592646,0.2764960346070656
769,37065,1207,775,631,165,432,1207,1.0,0.6420878210439105,0.35791217895608946,411,0.5227837613918807,0.13670256835128416,0.34051367025683515
770,37065,1750,1635,1384,52,115,1750,1.0,0.9342857142857143,0.06571428571428571,314,0.7908571428571428,0.029714285714285714,0.17942857142857144
771,37065,2238,917,856,741,1321,2238,1.0,0.4097408400357462,0.5902591599642538,641,0.38248436103663985,0.33109919571045576,0.2864164432529044
772,37065,2405,2191,1430,29,214,2405,1.0,0.911018711018711,0.08898128898128899,946,0.5945945945945946,0.012058212058212059,0.39334719334719337
773,37065,932,326,242,173,606,932,1.0,0.3497854077253219,0.6502145922746781,517,0.259656652360515,0.18562231759656653,0.5547210300429185
774,37065,1857,557,438,515,1300,1857,1.0,0.2999461497038234,0.7000538502961766,904,0.2358642972536349,0.2773290253096392,0.4868066774367259
775,37065,2520,1136,929,762,1384,2520,1.0,0.4507936507936508,0.5492063492063493,829,0.3686507936507937,0.30238095238095236,0.32896825396825397
776,37065,1329,225,174,530,1104,1329,1.0,0.16930022573363432,0.8306997742663657,625,0.1309255079006772,0.39879608728367194,0.47027840481565086
777,37065,700,366,286,161,334,700,1.0,0.5228571428571429,0.47714285714285715,253,0.4085714285714286,0.23,0.36142857142857143
778,37065,573,241,193,129,332,573,1.0,0.4205933682373473,0.5794066317626527,251,0.3368237347294939,0.225130890052356,0.43804537521815007
779,37065,3525,1506,1215,1007,2019,3525,1.0,0.4272340425531915,0.5727659574468085,1303,0.3446808510638298,0.2856737588652482,0.369645390070922
780,37065,1428,1375,967,4,53,1428,1.0,0.9628851540616247,0.03711484593837535,457,0.677170868347339,0.0028011204481792717,0.32002801120448177
781,37065,4130,3818,3038,95,312,4130,1.0,0.924455205811138,0.07554479418886198,997,0.735593220338983,0.023002421307506054,0.2414043583535109
782,37065,1595,345,283,555,1250,1595,1.0,0.21630094043887146,0.7836990595611285,757,0.1774294670846395,0.34796238244514105,0.4746081504702194
783,37065,1402,264,245,548,1138,1402,1.0,0.18830242510699002,0.81169757489301,609,0.17475035663338087,0.3908701854493581,0.43437945791726107
784,37065,1436,486,380,407,950,1436,1.0,0.3384401114206128,0.6615598885793872,649,0.2646239554317549,0.28342618384401114,0.451949860724234
785,37065,3689,1666,1334,939,2023,3689,1.0,0.45161290322580644,0.5483870967741935,1416,0.3616156139875305,0.2545405258877745,0.383843860124695
786,37065,2971,1126,799,938,1845,2971,1.0,0.37899697071693034,0.6210030292830697,1234,0.2689330191854594,0.3157186132615281,0.41534836755301247
787,37065,1459,655,505,402,804,1459,1.0,0.44893762851267993,0.5510623714873201,552,0.3461274845784784,0.27553118574366003,0.37834132967786155
788,37067,2721,90,621,1604,2631,2721,1.0,0.03307607497243661,0.9669239250275634,496,0.22822491730981256,0.5894891583976479,0.1822859242925395
789,37067,2515,382,531,735,2133,2515,1.0,0.15188866799204773,0.8481113320079523,1249,0.21113320079522863,0.2922465208747515,0.49662027833001987
790,37067,2669,544,889,796,2125,2669,1.0,0.20382165605095542,0.7961783439490446,984,0.33308355189209443,0.29823904083926567,0.36867740726863996
791,37067,1561,329,565,435,1232,1561,1.0,0.21076233183856502,0.7892376681614349,561,0.36194746957078794,0.2786675208199872,0.35938500960922487
792,37067,2567,607,938,525,1960,2567,1.0,0.23646279703934553,0.7635372029606544,1104,0.3654070899883132,0.2045188936501753,0.4300740163615115
793,37067,1820,112,486,1075,1708,1820,1.0,0.06153846153846154,0.9384615384615385,259,0.26703296703296703,0.5906593406593407,0.1423076923076923
794,37067,691,23,139,358,668,691,1.0,0.03328509406657019,0.9667149059334298,194,0.2011577424023155,0.5180897250361794,0.28075253256150506
795,37067,4400,1303,1446,778,3097,4400,1.0,0.29613636363636364,0.7038636363636364,2176,0.3286363636363636,0.17681818181818182,0.49454545454545457
796,37067,2920,292,913,1416,2628,2920,1.0,0.1,0.9,591,0.31267123287671234,0.4849315068493151,0.2023972602739726
797,37067,2928,2011,1373,138,917,2928,1.0,0.6868169398907104,0.3131830601092896,1417,0.4689207650273224,0.0471311475409836,0.483948087431694
798,37067,1886,162,412,927,1724,1886,1.0,0.08589607635206786,0.9141039236479321,547,0.21845174973488865,0.49151643690349944,0.2900318133616119
799,37067,3161,299,959,1188,2862,3161,1.0,0.09459031951913952,0.9054096804808605,1014,0.30338500474533375,0.3758304334071496,0.32078456184751664
800,37067,1845,147,514,940,1698,1845,1.0,0.07967479674796749,0.9203252032520325,391,0.2785907859078591,0.5094850948509485,0.21192411924119242
801,37067,2279,1591,1448,104,688,2279,1.0,0.6981132075471698,0.3018867924528302,727,0.635366388767003,0.045634050021939446,0.3189995612110575
802,37067,1888,1283,1063,31,605,1888,1.0,0.6795550847457628,0.3204449152542373,794,0.5630296610169492,0.01641949152542373,0.4205508474576271
803,37067,5895,457,1371,2467,5438,5895,1.0,0.07752332485156913,0.9224766751484309,2057,0.23256997455470738,0.418490245971162,0.34893977947413063
804,37067,3261,306,992,1628,2955,3261,1.0,0.09383624655013799,0.906163753449862,641,0.30420116528672186,0.4992333639987734,0.19656547071450475
805,37067,2519,336,540,932,2183,2519,1.0,0.1333862643906312,0.8666137356093688,1047,0.21437078205637158,0.36998809051210796,0.41564112743152043
806,37067,3959,1257,1362,832,2702,3959,1.0,0.3175044203081586,0.6824955796918414,1765,0.34402626925991414,0.21015407931295782,0.44581965142712804
807,37067,2446,194,895,1318,2252,2446,1.0,0.07931316434995912,0.9206868356500408,233,0.365903515944399,0.5388389206868357,0.09525756336876533
808,37067,1212,34,335,607,1178,1212,1.0,0.028052805280528052,0.971947194719472,270,0.2764026402640264,0.5008250825082509,0.22277227722772278
809,37067,3197,537,1172,1082,2660,3197,1.0,0.16796997184860807,0.8320300281513919,943,0.3665936815764779,0.33844228964654366,0.2949640287769784
810,37067,3413,194,926,1741,3219,3413,1.0,0.05684148842660416,0.9431585115733958,746,0.27131555815997654,0.5101084090243188,0.21857603281570465
811,37067,4468,1254,1778,1120,3214,4468,1.0,0.28066248880931066,0.7193375111906893,1570,0.39794091316025065,0.25067144136078784,0.3513876454789615
812,37067,3019,476,908,1062,2543,3019,1.0,0.1576681020205366,0.8423318979794634,1049,0.300761841669427,0.3517721099701888,0.34746604836038425
813,37067,1877,147,640,836,1730,1877,1.0,0.07831646244006393,0.921683537559936,401,0.3409696323921151,0.44539158231220033,0.2136387852956846
814,37067,2313,80,881,1250,2233,2313,1.0,0.03458711629917856,0.9654128837008215,182,0.3808906182447038,0.5404236921746649,0.07868568958063121
815,37067,2046,126,334,924,1920,2046,1.0,0.06158357771260997,0.9384164222873901,788,0.16324535679374388,0.45161290322580644,0.38514173998044965
816,37067,1356,284,512,492,1072,1356,1.0,0.20943952802359883,0.7905604719764012,352,0.3775811209439528,0.36283185840707965,0.25958702064896755
817,37067,3050,1321,1276,346,1729,3050,1.0,0.43311475409836064,0.5668852459016394,1428,0.4183606557377049,0.11344262295081967,0.4681967213114754
818,37067,1535,132,324,498,1403,1535,1.0,0.08599348534201955,0.9140065146579804,713,0.21107491856677524,0.3244299674267101,0.46449511400651466
819,37067,3324,1400,1246,263,1924,3324,1.0,0.42117930204572807,0.5788206979542719,1815,0.37484957882069797,0.07912154031287605,0.546028880866426
820,37067,2691,1159,1133,494,1532,2691,1.0,0.4306949089557785,0.5693050910442214,1064,0.42103307320698624,0.18357487922705315,0.39539204756596064
821,37067,3102,919,969,702,2183,3102,1.0,0.29626047711154097,0.7037395228884591,1431,0.31237911025145065,0.2263056092843327,0.46131528046421666
822,37067,5005,1245,1953,1611,3760,5005,1.0,0.24875124875124874,0.7512487512487512,1441,0.3902097902097902,0.32187812187812187,0.2879120879120879
823,37067,1225,76,527,486,1149,1225,1.0,0.062040816326530614,0.9379591836734694,212,0.43020408163265306,0.396734693877551,0.1730612244897959
824,37067,2050,293,786,627,1757,2050,1.0,0.14292682926829267,0.8570731707317073,637,0.38341463414634147,0.30585365853658536,0.31073170731707317
825,37067,5679,2839,2460,409,2840,5679,1.0,0.49991195633033986,0.5000880436696602,2810,0.43317485472794504,0.07201972178200387,0.4948054234900511
826,37067,2868,621,1044,830,2247,2868,1.0,0.21652719665271966,0.7834728033472803,994,0.36401673640167365,0.2894002789400279,0.34658298465829845
827,37067,3956,687,905,531,3269,3956,1.0,0.1736602628918099,0.8263397371081901,2520,0.2287664307381193,0.13422649140546006,0.6370070778564206
828,37067,3945,576,1340,979,3369,3945,1.0,0.14600760456273765,0.8539923954372624,1626,0.3396704689480355,0.24816223067173637,0.41216730038022814
829,37067,1617,84,757,595,1533,1617,1.0,0.05194805194805195,0.948051948051948,265,0.4681508967223253,0.36796536796536794,0.16388373531230674
830,37067,1486,273,481,589,1213,1486,1.0,0.18371467025572005,0.8162853297442799,416,0.32368775235531627,0.39636608344549124,0.27994616419919244
831,37067,1963,123,553,902,1840,1963,1.0,0.06265919510952624,0.9373408048904738,508,0.2817116658176261,0.45950076413652574,0.2587875700458482
832,37067,4178,1009,1525,1273,3169,4178,1.0,0.24150311153662038,0.7584968884633796,1380,0.365007180469124,0.3046912398276687,0.3303015797032073
833,37067,1492,316,554,379,1176,1492,1.0,0.21179624664879357,0.7882037533512064,559,0.37131367292225204,0.2540214477211796,0.3746648793565684
834,37067,1375,9,474,778,1366,1375,1.0,0.006545454545454545,0.9934545454545455,123,0.3447272727272727,0.5658181818181818,0.08945454545454545
835,37067,1471,8,428,991,1463,1471,1.0,0.005438477226376614,0.9945615227736234,52,0.2909585316111489,0.6736913664174031,0.03535010197144799
836,37067,3847,375,891,1868,3472,3847,1.0,0.09747855471796205,0.9025214452820379,1088,0.23160904600987783,0.4855731739017416,0.28281778008838054
837,37067,1749,168,762,444,1581,1749,1.0,0.09605488850771869,0.9039451114922813,543,0.43567753001715265,0.2538593481989708,0.31046312178387653
838,37067,4526,613,1239,2005,3913,4526,1.0,0.1354396818382678,0.8645603181617322,1282,0.27375165709235527,0.44299602297834734,0.2832523199292974
839,37067,4144,1515,1760,796,2629,4144,1.0,0.3655888030888031,0.634411196911197,1588,0.4247104247104247,0.1920849420849421,0.3832046332046332
840,37067,2039,1265,1160,109,774,2039,1.0,0.6204021579205493,0.3795978420794507,770,0.5689063266307013,0.05345757724374693,0.37763609612555177
841,37067,2324,1082,994,124,1242,2324,1.0,0.4655765920826162,0.5344234079173839,1206,0.42771084337349397,0.05335628227194492,0.5189328743545611
842,37067,1821,1211,1030,74,610,1821,1.0,0.6650192202086765,0.33498077979132346,717,0.5656232839099395,0.040637012630422846,0.39373970345963755
843,37067,3194,2753,1940,13,441,3194,1.0,0.8619286161552911,0.13807138384470882,1241,0.6073888541014402,0.004070131496556042,0.3885410144020038
844,37067,1974,951,834,108,1023,1974,1.0,0.4817629179331307,0.5182370820668692,1032,0.42249240121580545,0.0547112462006079,0.5227963525835866
845,37067,2318,164,588,1247,2154,2318,1.0,0.07075064710957722,0.9292493528904228,483,0.25366695427092323,0.5379637618636756,0.2083692838654012
846,37067,2254,602,765,424,1652,2254,1.0,0.2670807453416149,0.7329192546583851,1065,0.339396628216504,0.1881100266193434,0.47249334516415264
847,37067,2203,748,883,125,1455,2203,1.0,0.3395369950068089,0.6604630049931911,1195,0.4008170676350431,0.05674080798910577,0.5424421243758512
848,37067,2102,43,765,1117,2059,2102,1.0,0.020456707897240724,0.9795432921027593,220,0.36393910561370124,0.5313986679352997,0.10466222645099905
849,37067,2462,564,1068,305,1898,2462,1.0,0.22908204711616573,0.7709179528838342,1089,0.4337936636880585,0.12388302193338749,0.44232331437855404
850,37067,1092,37,428,589,1055,1092,1.0,0.03388278388278388,0.9661172161172161,75,0.39194139194139194,0.5393772893772893,0.06868131868131869
851,37067,2453,1542,1244,73,911,2453,1.0,0.6286180187525479,0.3713819812474521,1136,0.5071341214838972,0.029759478189971465,0.46310640032613126
852,37067,3353,496,790,1276,2857,3353,1.0,0.14792722934685357,0.8520727706531465,1287,0.23560990158067402,0.38055472711005073,0.38383537130927525
853,37067,3694,181,598,1907,3513,3694,1.0,0.04899837574445046,0.9510016242555496,1189,0.16188413643746616,0.516242555495398,0.3218733080671359
854,37067,3061,199,472,1082,2862,3061,1.0,0.06501143417183927,0.9349885658281607,1507,0.15419797451813133,0.3534792551453773,0.49232277033649136
855,37067,3021,145,439,1403,2876,3021,1.0,0.04799735187024164,0.9520026481297583,1179,0.145316120489904,0.4644157563720622,0.3902681231380338
856,37067,2858,259,617,857,2599,2858,1.0,0.09062281315605318,0.9093771868439469,1384,0.21588523442967109,0.2998600419874038,0.4842547235829251
857,37067,4197,1444,1738,1294,2753,4197,1.0,0.3440552775792233,0.6559447224207767,1165,0.4141053133190374,0.3083154634262569,0.27757922325470574
858,37067,2450,161,437,1068,2289,2450,1.0,0.06571428571428571,0.9342857142857143,945,0.1783673469387755,0.4359183673469388,0.38571428571428573
859,37067,1972,1825,1662,21,147,1972,1.0,0.9254563894523327,0.07454361054766734,289,0.8427991886409736,0.010649087221095335,0.14655172413793102
860,37067,2221,511,927,333,1710,2221,1.0,0.23007654209815398,0.769923457901846,961,0.4173795587573165,0.14993246285457001,0.43268797838811346
861,37067,3896,536,1074,1691,3360,3896,1.0,0.1375770020533881,0.8624229979466119,1131,0.27566735112936347,0.43403490759753593,0.2902977412731006
862,37067,4129,813,880,930,3316,4129,1.0,0.19689997578106078,0.8031000242189392,2319,0.21312666505207073,0.22523613465730202,0.5616372002906272
863,37067,2519,474,991,739,2045,2519,1.0,0.18816990869392616,0.8118300913060739,789,0.39341008336641525,0.2933703850734418,0.3132195315601429
864,37067,2819,630,772,237,2189,2819,1.0,0.22348350478893225,0.7765164952110678,1810,0.2738559772969138,0.08407236608726498,0.6420716566158212
865,37067,3937,431,870,1941,3506,3937,1.0,0.1094742189484379,0.8905257810515621,1126,0.22098044196088393,0.49301498602997207,0.28600457200914403
866,37067,1840,240,808,508,1600,1840,1.0,0.13043478260869565,0.8695652173913043,524,0.4391304347826087,0.27608695652173915,0.2847826086956522
867,37067,1168,1044,754,5,124,1168,1.0,0.8938356164383562,0.10616438356164383,409,0.6455479452054794,0.004280821917808219,0.3501712328767123
868,37067,1388,1028,810,23,360,1388,1.0,0.7406340057636888,0.25936599423631124,555,0.5835734870317003,0.016570605187319884,0.39985590778097985
869,37067,2696,1167,986,224,1529,2696,1.0,0.4328635014836795,0.5671364985163204,1486,0.36572700296735905,0.0830860534124629,0.5511869436201781
870,37067,1411,1266,1105,14,145,1411,1.0,0.8972360028348689,0.10276399716513111,292,0.7831325301204819,0.009922041105598866,0.2069454287739192
871,37067,2235,1786,1217,41,449,2235,1.0,0.7991051454138702,0.20089485458612977,977,0.5445190156599553,0.018344519015659956,0.43713646532438477
872,37067,5528,1905,2154,1274,3623,5528,1.0,0.34460926193921854,0.6553907380607815,2100,0.38965267727930536,0.2304630969609262,0.37988422575976843
873,37067,890,786,610,2,104,890,1.0,0.8831460674157303,0.11685393258426967,278,0.6853932584269663,0.0022471910112359553,0.31235955056179776
874,37067,1684,1506,1222,17,178,1684,1.0,0.8942992874109263,0.10570071258907364,445,0.7256532066508313,0.010095011876484561,0.2642517814726841
875,37067,1909,516,847,236,1393,1909,1.0,0.27029858564693554,0.7297014143530645,826,0.4436877946568884,0.12362493452069147,0.4326872708224201
876,37067,1489,1329,1163,4,160,1489,1.0,0.8925453324378778,0.10745466756212223,322,0.781061114842176,0.002686366689053056,0.216252518468771
877,37067,1977,422,635,439,1555,1977,1.0,0.21345472938796156,0.7865452706120385,903,0.32119372787051087,0.22205361659079415,0.456752655538695
878,37067,946,836,616,2,110,946,1.0,0.8837209302325582,0.11627906976744186,328,0.6511627906976745,0.0021141649048625794,0.346723044397463
879,37067,1246,39,553,337,1207,1246,1.0,0.03130016051364366,0.9686998394863563,356,0.4438202247191011,0.27046548956661315,0.2857142857142857
880,37067,3404,690,1007,1053,2714,3404,1.0,0.20270270270270271,0.7972972972972973,1344,0.29582843713278495,0.3093419506462985,0.39482961222091656
881,37067,2447,219,458,1049,2228,2447,1.0,0.0894973436861463,0.9105026563138537,940,0.1871679607682877,0.42868818961994276,0.3841438496117695
882,37067,1890,86,332,943,1804,1890,1.0,0.0455026455026455,0.9544973544973545,615,0.17566137566137566,0.49894179894179896,0.3253968253968254
883,37067,2560,343,634,1151,2217,2560,1.0,0.133984375,0.866015625,775,0.24765625,0.449609375,0.302734375
884,37067,2128,417,612,836,1711,2128,1.0,0.19595864661654136,0.8040413533834586,680,0.287593984962406,0.39285714285714285,0.31954887218045114
885,37067,2429,118,715,1345,2311,2429,1.0,0.04857966241251544,0.9514203375874846,369,0.2943598188554961,0.5537258130918074,0.1519143680526966
886,37067,2866,162,802,1540,2704,2866,1.0,0.056524773203070484,0.9434752267969295,524,0.27983251919050944,0.537334263782275,0.18283321702721564
887,37067,2992,197,676,1284,2795,2992,1.0,0.06584224598930481,0.9341577540106952,1032,0.22593582887700533,0.42914438502673796,0.3449197860962567
888,37067,4673,181,1311,2617,4492,4673,1.0,0.038733147870746845,0.9612668521292531,745,0.28054782794778516,0.5600256794350524,0.15942649261716244
889,37069,1606,544,454,434,1062,1606,1.0,0.33872976338729766,0.6612702366127023,718,0.28268991282689915,0.27023661270236615,0.44707347447073476
890,37069,2087,869,780,421,1218,2087,1.0,0.4163871586008625,0.5836128413991375,886,0.37374221370388117,0.2017249640632487,0.42453282223287014
891,37069,1844,396,451,643,1448,1844,1.0,0.21475054229934923,0.7852494577006508,750,0.2445770065075922,0.34869848156182215,0.4067245119305857
892,37069,4085,716,1141,1655,3369,4085,1.0,0.17527539779681764,0.8247246022031823,1289,0.2793145654834761,0.40514075887392903,0.31554467564259486
893,37069,3341,908,1115,974,2433,3341,1.0,0.27177491768931455,0.7282250823106854,1252,0.3337324154444777,0.2915294821909608,0.3747381023645615
894,37069,2987,1527,1400,565,1460,2987,1.0,0.5112152661533311,0.4887847338466689,1022,0.4686976899899565,0.18915299631737528,0.3421493136926682
895,37069,1799,821,627,403,978,1799,1.0,0.4563646470261256,0.5436353529738743,769,0.34852695942190104,0.22401334074485826,0.42745969983324067
896,37069,2427,1057,696,478,1370,2427,1.0,0.43551709929954674,0.5644829007004533,1253,0.2867737948084054,0.1969509682735888,0.5162752369180058
897,37069,2661,1226,1010,433,1435,2661,1.0,0.46072904922961294,0.5392709507703871,1218,0.3795565576850808,0.16272078166102968,0.4577226606538895
898,37069,3781,460,984,1626,3321,3781,1.0,0.12166093626024861,0.8783390637397513,1171,0.26024861147844486,0.43004496165035705,0.3097064268711981
899,37069,1885,165,313,760,1720,1885,1.0,0.08753315649867374,0.9124668435013262,812,0.1660477453580902,0.40318302387267907,0.4307692307692308
900,37069,2940,599,789,1042,2341,2940,1.0,0.20374149659863947,0.7962585034013605,1109,0.2683673469387755,0.354421768707483,0.3772108843537415
901,37069,2096,274,436,822,1822,2096,1.0,0.13072519083969467,0.8692748091603053,838,0.20801526717557253,0.39217557251908397,0.3998091603053435
902,37069,1280,343,285,444,937,1280,1.0,0.26796875,0.73203125,551,0.22265625,0.346875,0.43046875
903,37069,2507,296,649,1108,2211,2507,1.0,0.11806940566414041,0.8819305943358596,750,0.2588751495811727,0.4419625049860391,0.2991623454327882
904,37069,2358,1047,927,564,1311,2358,1.0,0.4440203562340967,0.5559796437659033,867,0.3931297709923664,0.23918575063613232,0.36768447837150126
905,37069,2621,491,584,840,2130,2621,1.0,0.18733307897748952,0.8126669210225105,1197,0.22281571919114843,0.32048836322014496,0.4566959175887066
906,37069,3452,444,795,1391,3008,3452,1.0,0.12862108922363846,0.8713789107763615,1266,0.23030127462340672,0.402954808806489,0.3667439165701043
907,37071,2736,147,404,891,2589,2736,1.0,0.0537280701754386,0.9462719298245614,1441,0.1476608187134503,0.3256578947368421,0.5266812865497076
908,37071,4072,722,1077,1621,3350,4072,1.0,0.17730844793713163,0.8226915520628684,1374,0.2644891944990177,0.3980844793713163,0.337426326129666
909,37071,5274,291,831,2223,4983,5274,1.0,0.055176336746302616,0.9448236632536974,2220,0.15756541524459614,0.42150170648464164,0.42093287827076226
910,37071,2910,138,415,885,2772,2910,1.0,0.04742268041237113,0.9525773195876288,1610,0.14261168384879724,0.30412371134020616,0.5532646048109966
911,37071,1787,1280,798,35,507,1787,1.0,0.7162842753217683,0.2837157246782317,954,0.44655847789591496,0.019585898153329603,0.5338556239507555
912,37071,3429,1445,1195,428,1984,3429,1.0,0.4214056576261301,0.57859434237387,1806,0.3484981044036162,0.12481773111694372,0.5266841644794401
913,37071,2849,625,645,770,2224,2849,1.0,0.21937521937521937,0.7806247806247806,1434,0.22639522639522638,0.2702702702702703,0.5033345033345034
914,37071,4136,426,669,1157,3710,4136,1.0,0.1029980657640232,0.8970019342359767,2310,0.16175048355899418,0.2797388781431335,0.5585106382978723
915,37071,2882,95,353,1052,2787,2882,1.0,0.03296321998612075,0.9670367800138793,1477,0.12248438584316447,0.3650242886884108,0.5124913254684247
916,37071,1115,66,317,534,1049,1115,1.0,0.059192825112107626,0.9408071748878923,264,0.284304932735426,0.4789237668161435,0.2367713004484305
917,37071,6431,1057,1755,2207,5374,6431,1.0,0.16436013061732235,0.8356398693826776,2469,0.27289690561343494,0.343181464779972,0.38392162960659304
918,37071,3527,563,830,1159,2964,3527,1.0,0.1596257442585767,0.8403742557414233,1538,0.23532747377374538,0.32860788205273606,0.4360646441735186
919,37071,2998,630,865,1002,2368,2998,1.0,0.21014009339559706,0.789859906604403,1131,0.2885256837891928,0.3342228152101401,0.3772515010006671
920,37071,3183,76,383,1531,3107,3183,1.0,0.023876845743009738,0.9761231542569903,1269,0.12032673578385171,0.4809927741124725,0.3986804901036758
921,37071,2328,136,408,1182,2192,2328,1.0,0.058419243986254296,0.9415807560137457,738,0.17525773195876287,0.5077319587628866,0.3170103092783505
922,37071,5514,895,1456,2424,4619,5514,1.0,0.16231410953935438,0.8376858904606457,1634,0.2640551323902793,0.4396082698585419,0.2963365977511788
923,37071,4107,92,355,1827,4015,4107,1.0,0.022400779157535914,0.9775992208424641,1925,0.08643778914049184,0.44485025566106645,0.46871195519844167
924,37071,4557,471,803,1837,4086,4557,1.0,0.10335747202106649,0.8966425279789335,1917,0.1762124204520518,0.4031160851437349,0.4206714944042133
925,37071,2439,1166,1067,230,1273,2439,1.0,0.4780647806478065,0.5219352193521936,1142,0.43747437474374745,0.0943009430094301,0.46822468224682245
926,37071,4526,443,884,1777,4083,4526,1.0,0.09787892178524082,0.9021210782147592,1865,0.19531595227574017,0.39262041537781706,0.4120636323464428
927,37071,3290,221,527,1666,3069,3290,1.0,0.06717325227963526,0.9328267477203648,1097,0.1601823708206687,0.5063829787234042,0.3334346504559271
928,37071,6099,767,1075,1854,5332,6099,1.0,0.12575832103623544,0.8742416789637646,3170,0.17625840301688803,0.30398425971470733,0.5197573372684047
929,37071,5142,827,948,1818,4315,5142,1.0,0.16083236094904707,0.8391676390509529,2376,0.18436406067677946,0.35355892648774795,0.4620770128354726
930,37071,4937,468,939,2288,4469,4937,1.0,0.09479440956046181,0.9052055904395382,1710,0.19019647559246505,0.4634393356289244,0.34636418877861047
931,37071,3546,149,487,1427,3397,3546,1.0,0.04201917653694304,0.957980823463057,1632,0.13733784545967287,0.4024252679075014,0.4602368866328257
932,37071,2368,933,843,399,1435,2368,1.0,0.3940033783783784,0.6059966216216216,1126,0.3559966216216216,0.16849662162162163,0.47550675675675674
933,37071,2880,368,635,997,2512,2880,1.0,0.12777777777777777,0.8722222222222222,1248,0.2204861111111111,0.34618055555555555,0.43333333333333335
934,37071,3625,168,492,1429,3457,3625,1.0,0.046344827586206894,0.953655172413793,1704,0.1357241379310345,0.39420689655172414,0.47006896551724137
935,37071,1921,166,321,762,1755,1921,1.0,0.0864133263925039,0.9135866736074961,838,0.16710046850598648,0.39666840187402397,0.4362311296199896
936,37071,6206,1143,1349,1677,5063,6206,1.0,0.18417660328714147,0.8158233967128585,3180,0.21737028681920723,0.2702223654527876,0.5124073477280051
937,37071,3120,114,652,1471,3006,3120,1.0,0.03653846153846154,0.9634615384615385,997,0.20897435897435898,0.47147435897435896,0.319551282051282
938,37071,3293,166,834,1945,3127,3293,1.0,0.05040996052232007,0.94959003947768,514,0.2532645004555117,0.5906468266018828,0.15608867294260553
939,37071,1667,163,320,689,1504,1667,1.0,0.09778044391121776,0.9022195560887822,658,0.19196160767846432,0.4133173365326935,0.39472105578884226
940,37071,3335,228,562,1129,3107,3335,1.0,0.06836581709145427,0.9316341829085457,1644,0.16851574212893553,0.3385307346326837,0.4929535232383808
941,37071,2681,212,499,973,2469,2681,1.0,0.07907497202536368,0.9209250279746364,1209,0.18612458038045504,0.3629242819843342,0.4509511376352107
942,37071,2649,131,289,958,2518,2649,1.0,0.04945262363155908,0.9505473763684409,1402,0.10909777274443186,0.3616459041147603,0.5292563231408078
943,37071,2616,779,698,400,1837,2616,1.0,0.297782874617737,0.702217125382263,1518,0.2668195718654434,0.1529051987767584,0.5802752293577982
944,37071,2476,628,624,605,1848,2476,1.0,0.25363489499192243,0.7463651050080775,1247,0.2520193861066236,0.24434571890145396,0.5036348949919225
945,37071,3033,301,691,913,2732,3033,1.0,0.0992416749093307,0.9007583250906693,1429,0.22782723376195185,0.30102209033959776,0.4711506758984504
946,37071,1361,264,418,389,1097,1361,1.0,0.19397501836884642,0.8060249816311535,554,0.3071271124173402,0.2858192505510654,0.4070536370315944
947,37071,3575,174,649,1963,3401,3575,1.0,0.04867132867132867,0.9513286713286714,963,0.18153846153846154,0.5490909090909091,0.2693706293706294
948,37071,3162,1026,1005,570,2136,3162,1.0,0.32447817836812143,0.6755218216318786,1587,0.3178368121442125,0.18026565464895636,0.5018975332068312
949,37071,2290,911,743,309,1379,2290,1.0,0.3978165938864629,0.6021834061135372,1238,0.32445414847161574,0.1349344978165939,0.5406113537117904
950,37071,2937,241,717,1223,2696,2937,1.0,0.08205652025876745,0.9179434797412326,997,0.24412665985699694,0.4164113040517535,0.3394620360912496
951,37071,3510,278,738,1991,3232,3510,1.0,0.07920227920227921,0.9207977207977208,781,0.21025641025641026,0.5672364672364673,0.2225071225071225
952,37071,4326,354,606,1521,3972,4326,1.0,0.08183079056865465,0.9181692094313454,2199,0.14008321775312066,0.35159500693481277,0.5083217753120666
953,37073,1204,297,318,432,907,1204,1.0,0.24667774086378738,0.7533222591362126,454,0.26411960132890366,0.3588039867109635,0.3770764119601329
954,37073,1689,850,639,380,839,1689,1.0,0.5032563647128478,0.49674363528715215,670,0.3783303730017762,0.22498519834221434,0.39668442865600945
955,37073,2266,893,734,506,1373,2266,1.0,0.3940864960282436,0.6059135039717564,1026,0.32391879964695497,0.22330097087378642,0.4527802294792586
956,37073,1106,142,213,419,964,1106,1.0,0.12839059674502712,0.8716094032549728,474,0.19258589511754068,0.37884267631103075,0.42857142857142855
957,37073,1064,496,449,244,568,1064,1.0,0.46616541353383456,0.5338345864661654,371,0.42199248120300753,0.22932330827067668,0.34868421052631576
958,37073,1965,414,393,558,1551,1965,1.0,0.21068702290076335,0.7893129770992366,1014,0.2,0.28396946564885495,0.516030534351145
959,37075,500,0,50,274,500,500,1.0,0.0,1.0,176,0.1,0.548,0.352
960,37075,1183,0,180,545,1183,1183,1.0,0.0,1.0,458,0.1521555367709214,0.4606931530008453,0.3871513102282333
961,37075,2484,2,401,883,2482,2484,1.0,0.0008051529790660225,0.999194847020934,1200,0.16143317230273752,0.355475040257649,0.4830917874396135
962,37075,2781,2,488,1048,2779,2781,1.0,0.000719165767709457,0.9992808342322905,1245,0.1754764473211075,0.3768428622797555,0.447680690399137
963,37077,1818,601,563,581,1217,1818,1.0,0.33058305830583057,0.6694169416941694,674,0.3096809680968097,0.3195819581958196,0.37073707370737075
964,37077,1426,583,521,400,843,1426,1.0,0.40883590462833097,0.591164095371669,505,0.3653576437587658,0.2805049088359046,0.3541374474053296
965,37077,2162,1168,1117,499,994,2162,1.0,0.5402405180388529,0.4597594819611471,546,0.5166512488436633,0.23080481036077705,0.25254394079555964
966,37077,1087,645,662,240,442,1087,1.0,0.593376264949402,0.40662373505059796,185,0.609015639374425,0.22079116835326587,0.1701931922723091
967,37077,2159,648,639,656,1511,2159,1.0,0.3001389532190829,0.6998610467809171,864,0.29597035664659566,0.30384437239462714,0.4001852709587772
968,37077,2054,986,933,449,1068,2054,1.0,0.4800389483933788,0.5199610516066212,672,0.4542356377799416,0.21859785783836416,0.32716650438169426
969,37077,2009,637,628,684,1372,2009,1.0,0.3170731707317073,0.6829268292682927,697,0.3125933300149328,0.34046789447486314,0.3469387755102041
970,37077,4219,646,941,1657,3573,4219,1.0,0.15311685233467645,0.8468831476653236,1621,0.22303863474757052,0.3927470964683574,0.38421426878407205
971,37077,1699,878,787,293,821,1699,1.0,0.516774573278399,0.48322542672160096,619,0.46321365509123014,0.17245438493231313,0.36433195997645673
972,37077,2668,811,796,807,1857,2668,1.0,0.3039730134932534,0.6960269865067467,1065,0.2983508245877061,0.30247376311844076,0.39917541229385306
973,37077,1706,1076,966,218,630,1706,1.0,0.6307151230949589,0.369284876905041,522,0.5662368112543963,0.12778429073856976,0.305978898007034
974,37077,4845,476,1102,2108,4369,4845,1.0,0.09824561403508772,0.9017543859649123,1635,0.22745098039215686,0.43508771929824563,0.33746130030959753
975,37077,4794,1355,1588,1480,3439,4794,1.0,0.28264497288277013,0.7173550271172299,1726,0.3312473925740509,0.3087192323738006,0.3600333750521485
976,37077,9895,4183,1190,802,5712,9895,1.0,0.4227387569479535,0.5772612430520465,7903,0.12026275896917635,0.08105103587670541,0.7986862051541183
977,37077,4042,758,1165,1531,3284,4042,1.0,0.18753092528451262,0.8124690747154873,1346,0.2882236516575952,0.3787728847105393,0.3330034636318654
978,37079,1249,427,292,296,822,1249,1.0,0.3418734987990392,0.6581265012009607,661,0.23378702962369896,0.23698959167333866,0.5292233787029623
979,37079,1989,535,427,670,1454,1989,1.0,0.26897938662644544,0.7310206133735545,892,0.21468074409250879,0.3368526897938663,0.44846656611362495
980,37079,1550,445,378,383,1105,1550,1.0,0.2870967741935484,0.7129032258064516,789,0.24387096774193548,0.2470967741935484,0.5090322580645161
981,37079,1100,327,241,409,773,1100,1.0,0.2972727272727273,0.7027272727272728,450,0.2190909090909091,0.3718181818181818,0.4090909090909091
982,37079,1060,294,262,393,766,1060,1.0,0.27735849056603773,0.7226415094339622,405,0.24716981132075472,0.37075471698113205,0.38207547169811323
983,37079,4104,1963,576,616,2141,4104,1.0,0.4783138401559454,0.5216861598440545,2912,0.14035087719298245,0.15009746588693956,0.7095516569200779
984,37079,2002,796,667,596,1206,2002,1.0,0.39760239760239763,0.6023976023976024,739,0.33316683316683315,0.2977022977022977,0.3691308691308691
985,37079,1269,485,329,389,784,1269,1.0,0.3821907013396375,0.6178092986603625,551,0.25925925925925924,0.3065405831363278,0.43420015760441294
986,37079,1121,486,393,323,635,1121,1.0,0.4335414808206958,0.5664585191793042,405,0.35057983942908116,0.288135593220339,0.36128456735057984
987,37079,966,283,213,336,683,966,1.0,0.29296066252587993,0.7070393374741201,417,0.2204968944099379,0.34782608695652173,0.43167701863354035
988,37081,2846,1150,1143,258,1696,2846,1.0,0.4040758959943781,0.5959241040056219,1445,0.4016163035839775,0.09065354884047787,0.5077301475755446
989,37081,3529,2973,1910,33,556,3529,1.0,0.8424482856333239,0.15755171436667612,1586,0.5412298101445169,0.009351090960612072,0.4494190988948711
990,37081,7725,2050,2839,2139,5675,7725,1.0,0.26537216828478966,0.7346278317152104,2747,0.3675080906148867,0.27689320388349514,0.3555987055016181
991,37081,4072,696,1634,540,3376,4072,1.0,0.17092337917485265,0.8290766208251473,1898,0.4012770137524558,0.13261296660117877,0.46611001964636545
992,37081,2505,1831,1734,107,674,2505,1.0,0.730938123752495,0.269061876247505,664,0.6922155688622754,0.04271457085828343,0.2650698602794411
993,37081,2493,2315,1956,9,178,2493,1.0,0.9286000802246289,0.07139991977537104,528,0.7845968712394705,0.0036101083032490976,0.21179302045728038
994,37081,2919,753,1198,256,2166,2919,1.0,0.2579650565262076,0.7420349434737924,1465,0.4104145255224392,0.08770126755738267,0.5018842069201781
995,37081,3797,965,1937,342,2832,3797,1.0,0.25414801158809586,0.7458519884119041,1518,0.5101395838820121,0.09007110877008165,0.39978930734790624
996,37081,1877,438,759,491,1439,1877,1.0,0.23335109216835376,0.7666489078316463,627,0.40436867341502397,0.2615876398508258,0.33404368673415025
997,37081,2879,2454,1758,13,425,2879,1.0,0.8523792983674887,0.1476207016325113,1108,0.6106286905175408,0.0045154567558179926,0.3848558527266412
998,37081,1658,692,643,135,966,1658,1.0,0.41737032569360677,0.5826296743063932,880,0.38781664656212306,0.08142340168878166,0.5307599517490953
999,37081,1138,30,638,318,1108,1138,1.0,0.026362038664323375,0.9736379613356766,182,0.5606326889279437,0.27943760984182775,0.15992970123022848
1000,37081,1607,1492,1270,5,115,1607,1.0,0.9284380833851898,0.0715619166148102,332,0.790292470441817,0.0031113876789047915,0.20659614187927816
1001,37081,1405,73,681,388,1332,1405,1.0,0.05195729537366548,0.9480427046263346,336,0.48469750889679714,0.27615658362989326,0.2391459074733096
1002,37081,3445,1233,1337,458,2212,3445,1.0,0.3579100145137881,0.6420899854862119,1650,0.38809869375907113,0.13294629898403484,0.47895500725689405
1003,37081,2845,2638,1904,8,207,2845,1.0,0.9272407732864675,0.07275922671353251,933,0.6692442882249561,0.00281195079086116,0.32794376098418276
1004,37081,2686,2080,1726,61,606,2686,1.0,0.774385703648548,0.22561429635145197,899,0.6425912137006702,0.022710349962769917,0.33469843633655993
1005,37081,1248,678,875,69,570,1248,1.0,0.5432692307692307,0.4567307692307692,304,0.7011217948717948,0.055288461538461536,0.24358974358974358
1006,37081,1327,26,596,645,1301,1327,1.0,0.019593067068575734,0.9804069329314242,86,0.44913338357196686,0.4860587792012057,0.06480783722682742
1007,37081,1493,194,788,275,1299,1493,1.0,0.12993971868720697,0.870060281312793,430,0.5277963831212324,0.1841929002009377,0.28801071667782985
1008,37081,1444,81,733,365,1363,1444,1.0,0.05609418282548476,0.9439058171745153,346,0.5076177285318559,0.25277008310249305,0.23961218836565096
1009,37081,2395,753,992,649,1642,2395,1.0,0.31440501043841335,0.6855949895615866,754,0.41419624217119,0.2709812108559499,0.3148225469728601
1010,37081,1176,84,648,174,1092,1176,1.0,0.07142857142857142,0.9285714285714286,354,0.5510204081632653,0.14795918367346939,0.3010204081632653
1011,37081,3986,1444,1426,560,2542,3986,1.0,0.3622679377822378,0.6377320622177621,2000,0.3577521324636227,0.14049172102358254,0.5017561465127948
1012,37081,1072,24,520,481,1048,1072,1.0,0.022388059701492536,0.9776119402985075,71,0.48507462686567165,0.44869402985074625,0.06623134328358209
1013,37081,2508,404,1057,748,2104,2508,1.0,0.16108452950558214,0.8389154704944178,703,0.42145135566188197,0.2982456140350877,0.2803030303030303
1014,37081,2066,453,799,613,1613,2066,1.0,0.21926427879961277,0.7807357212003873,654,0.38673765730880927,0.2967086156824782,0.3165537270087125
1015,37081,2355,1831,1385,61,524,2355,1.0,0.7774946921443737,0.22250530785562633,909,0.5881104033970276,0.025902335456475585,0.38598726114649684
1016,37081,3710,709,1111,1462,3001,3710,1.0,0.19110512129380053,0.8088948787061995,1137,0.29946091644204853,0.3940700808625337,0.30646900269541777
1017,37081,1680,100,655,689,1580,1680,1.0,0.05952380952380952,0.9404761904761905,336,0.3898809523809524,0.4101190476190476,0.2
1018,37081,1184,20,363,663,1164,1184,1.0,0.016891891891891893,0.9831081081081081,158,0.30658783783783783,0.5599662162162162,0.13344594594594594
1019,37081,2790,252,978,1052,2538,2790,1.0,0.09032258064516129,0.9096774193548387,760,0.35053763440860214,0.37706093189964157,0.2724014336917563
1020,37081,1661,180,501,669,1481,1661,1.0,0.10836845273931367,0.8916315472606864,491,0.3016255267910897,0.4027694160144491,0.2956050571944612
1021,37081,1599,547,532,218,1052,1599,1.0,0.3420888055034397,0.6579111944965603,849,0.33270794246404,0.13633520950594122,0.5309568480300187
1022,37081,2147,183,789,489,1964,2147,1.0,0.08523521192361434,0.9147647880763856,869,0.36748952026082904,0.22775966464834654,0.4047508150908244
1023,37081,1547,25,593,837,1522,1547,1.0,0.01616031027795734,0.9838396897220426,117,0.38332255979314805,0.5410471881060116,0.07563025210084033
1024,37081,3746,297,902,2042,3449,3746,1.0,0.0792845702082221,0.9207154297917779,802,0.2407901761879338,0.5451147891083823,0.21409503470368393
1025,37081,1611,68,679,815,1543,1611,1.0,0.04220980757293606,0.957790192427064,117,0.42147734326505276,0.5058969584109249,0.07262569832402235
1026,37081,3587,1451,1436,420,2136,3587,1.0,0.40451630889322554,0.5954836911067745,1731,0.4003345413994982,0.11708948982436576,0.48257596877613607
1027,37081,1465,1366,1209,12,99,1465,1.0,0.9324232081911262,0.06757679180887372,244,0.8252559726962457,0.008191126279863481,0.16655290102389078
1028,37081,2294,1839,1465,70,455,2294,1.0,0.8016564952048822,0.1983435047951177,759,0.6386224934612031,0.03051438535309503,0.3308631211857018
1029,37081,2471,287,850,1051,2184,2471,1.0,0.11614730878186968,0.8838526912181303,570,0.3439902873330635,0.42533387292594094,0.23067583974099554
1030,37081,1490,74,532,599,1416,1490,1.0,0.049664429530201344,0.9503355704697987,359,0.35704697986577183,0.40201342281879193,0.24093959731543624
1031,37081,2714,1348,1043,325,1366,2714,1.0,0.496683861459101,0.5033161385408991,1346,0.3843036109064112,0.11974944731024319,0.49594694178334564
1032,37081,2235,127,920,1138,2108,2235,1.0,0.056823266219239374,0.9431767337807606,177,0.4116331096196868,0.50917225950783,0.07919463087248323
1033,37081,1609,301,588,438,1308,1609,1.0,0.18707271597265382,0.8129272840273462,583,0.36544437538844005,0.27221876942200124,0.3623368551895587
1034,37081,1575,1360,1198,27,215,1575,1.0,0.8634920634920635,0.1365079365079365,350,0.7606349206349207,0.017142857142857144,0.2222222222222222
1035,37081,3013,861,754,344,2152,3013,1.0,0.28576169930302026,0.7142383006969798,1915,0.2502489213408563,0.1141719216727514,0.6355791569863923
1036,37081,3404,898,972,571,2506,3404,1.0,0.26380728554641597,0.736192714453584,1861,0.28554641598119856,0.16774383078730906,0.5467097532314924
1037,37081,2901,1207,843,205,1694,2901,1.0,0.416063426404688,0.5839365735953119,1853,0.2905894519131334,0.07066528783178215,0.6387452602550845
1038,37081,1979,406,473,604,1573,1979,1.0,0.20515411824153612,0.7948458817584638,902,0.23900960080848913,0.30520464881253156,0.4557857503789793
1039,37081,1565,1127,762,34,438,1565,1.0,0.7201277955271566,0.27987220447284344,769,0.48690095846645365,0.021725239616613417,0.4913738019169329
1040,37081,3761,584,1173,1259,3177,3761,1.0,0.1552778516352034,0.8447221483647966,1329,0.3118851369316671,0.3347513959053443,0.35336346716298855
1041,37081,1556,132,516,903,1424,1556,1.0,0.08483290488431877,0.9151670951156813,137,0.33161953727506427,0.5803341902313625,0.08804627249357326
1042,37081,2510,465,799,877,2045,2510,1.0,0.1852589641434263,0.8147410358565738,834,0.3183266932270916,0.349402390438247,0.3322709163346614
1043,37081,1463,363,581,301,1100,1463,1.0,0.24812030075187969,0.7518796992481203,581,0.39712918660287083,0.20574162679425836,0.39712918660287083
1044,37081,1567,72,561,775,1495,1567,1.0,0.04594767070835992,0.9540523292916401,231,0.3580089342693044,0.49457562220804085,0.14741544352265476
1045,37081,3065,801,1118,1098,2264,3065,1.0,0.26133768352365416,0.7386623164763458,849,0.36476345840130503,0.35823817292006527,0.2769983686786297
1046,37081,1670,121,604,622,1549,1670,1.0,0.07245508982035928,0.9275449101796407,444,0.36167664670658684,0.3724550898203593,0.26586826347305387
1047,37081,3953,948,1309,1221,3005,3953,1.0,0.239817859853276,0.760182140146724,1423,0.3311409056412851,0.30887933215279534,0.35997976220591954
1048,37081,1608,194,517,653,1414,1608,1.0,0.12064676616915423,0.8793532338308457,438,0.3215174129353234,0.4060945273631841,0.27238805970149255
1049,37081,2182,52,276,1184,2130,2182,1.0,0.02383134738771769,0.9761686526122824,722,0.12648945921173235,0.5426214482126489,0.3308890925756187
1050,37081,2104,75,323,1182,2029,2104,1.0,0.03564638783269962,0.9643536121673004,599,0.1535171102661597,0.561787072243346,0.2846958174904943
1051,37081,1971,1496,992,71,475,1971,1.0,0.7590055809233891,0.24099441907661084,908,0.5032978183663115,0.03602232369355657,0.4606798579401319
1052,37081,2775,191,537,1505,2584,2775,1.0,0.06882882882882883,0.9311711711711712,733,0.1935135135135135,0.5423423423423424,0.26414414414414417
1053,37081,2015,239,518,838,1776,2015,1.0,0.11861042183622829,0.8813895781637717,659,0.25707196029776674,0.41588089330024813,0.3270471464019851
1054,37081,2246,401,746,485,1845,2246,1.0,0.17853962600178094,0.821460373998219,1015,0.3321460373998219,0.21593944790739092,0.45191451469278715
1055,37081,1948,429,806,608,1519,1948,1.0,0.2202258726899384,0.7797741273100616,534,0.4137577002053388,0.31211498973305957,0.2741273100616016
1056,37081,1387,98,411,725,1289,1387,1.0,0.07065609228550829,0.9293439077144917,251,0.29632299927901945,0.5227108868060563,0.1809661139149243
1057,37081,1341,183,498,462,1158,1341,1.0,0.13646532438478748,0.8635346756152126,381,0.3713646532438479,0.34451901565995524,0.2841163310961969
1058,37081,1515,214,547,684,1301,1515,1.0,0.14125412541254126,0.8587458745874588,284,0.36105610561056106,0.4514851485148515,0.18745874587458747
1059,37081,3145,1875,1667,291,1270,3145,1.0,0.5961844197138315,0.40381558028616854,1187,0.5300476947535772,0.09252782193958664,0.37742448330683626
1060,37081,3455,352,1017,1510,3103,3455,1.0,0.10188133140376267,0.8981186685962373,928,0.294356005788712,0.4370477568740955,0.26859623733719246
1061,37081,3471,1965,1676,369,1506,3471,1.0,0.5661192739844425,0.4338807260155575,1426,0.4828579660040334,0.1063094209161625,0.41083261307980407
1062,37081,2148,50,296,1288,2098,2148,1.0,0.023277467411545624,0.9767225325884544,564,0.1378026070763501,0.5996275605214153,0.26256983240223464
1063,37081,2826,1257,1506,593,1569,2826,1.0,0.4447983014861996,0.5552016985138004,727,0.5329087048832272,0.20983722576079264,0.25725406935598016
1064,37081,2522,2058,1312,21,464,2522,1.0,0.8160190325138779,0.18398096748612214,1189,0.5202220459952419,0.008326724821570182,0.47145122918318794
1065,37081,1857,53,212,793,1804,1857,1.0,0.028540656973613354,0.9714593430263866,852,0.11416262789445342,0.42703284868066776,0.4588045234248788
1066,37081,1306,50,263,876,1256,1306,1.0,0.03828483920367534,0.9617151607963247,167,0.20137825421133232,0.6707503828483921,0.12787136294027565
1067,37081,1876,695,680,274,1181,1876,1.0,0.3704690831556503,0.6295309168443497,922,0.3624733475479744,0.1460554371002132,0.4914712153518124
1068,37081,2779,1645,1275,200,1134,2779,1.0,0.5919395465994962,0.4080604534005038,1304,0.4587981288233177,0.07196833393306945,0.46923353724361283
1069,37081,3542,1428,1149,180,2114,3542,1.0,0.4031620553359684,0.5968379446640316,2213,0.3243929983060418,0.050818746470920384,0.6247882552230378
1070,37081,3135,852,1175,799,2283,3135,1.0,0.27177033492822966,0.7282296650717703,1161,0.3748006379585327,0.25486443381180224,0.3703349282296651
1071,37081,2280,1709,1420,126,571,2280,1.0,0.749561403508772,0.25043859649122807,734,0.6228070175438597,0.05526315789473684,0.3219298245614035
1072,37081,1401,244,593,396,1157,1401,1.0,0.17416131334760884,0.8258386866523911,412,0.42326909350463954,0.2826552462526767,0.2940756602426838
1073,37081,2796,893,1017,629,1903,2796,1.0,0.31938483547925606,0.6806151645207439,1150,0.36373390557939916,0.224964234620887,0.4113018597997139
1074,37081,2740,491,729,1110,2249,2740,1.0,0.1791970802919708,0.8208029197080292,901,0.26605839416058397,0.4051094890510949,0.3288321167883212
1075,37081,3025,425,1122,1229,2600,3025,1.0,0.14049586776859505,0.859504132231405,674,0.3709090909090909,0.40628099173553717,0.2228099173553719
1076,37081,1807,214,646,744,1593,1807,1.0,0.11842833425567238,0.8815716657443277,417,0.3574986164914222,0.411732152739347,0.23076923076923078
1077,37081,2182,384,904,1048,1798,2182,1.0,0.1759853345554537,0.8240146654445463,230,0.4142988084326306,0.48029330889092575,0.10540788267644363
1078,37081,1818,203,677,841,1615,1818,1.0,0.11166116611661166,0.8883388338833883,300,0.37238723872387236,0.46259625962596257,0.16501650165016502
1079,37081,2355,146,852,1214,2209,2355,1.0,0.06199575371549894,0.9380042462845011,289,0.36178343949044584,0.5154989384288747,0.1227176220806794
1080,37081,2877,687,792,1075,2190,2877,1.0,0.23879040667361837,0.7612095933263816,1010,0.27528675703858185,0.37365311087938824,0.3510601320820299
1081,37081,3280,216,930,1682,3064,3280,1.0,0.06585365853658537,0.9341463414634147,668,0.28353658536585363,0.5128048780487805,0.20365853658536584
1082,37081,1065,155,142,509,910,1065,1.0,0.14553990610328638,0.8544600938967136,414,0.13333333333333333,0.4779342723004695,0.38873239436619716
1083,37081,4905,2367,2297,1032,2538,4905,1.0,0.48256880733944957,0.5174311926605505,1576,0.46829765545361873,0.21039755351681957,0.32130479102956166
1084,37081,2199,134,553,1320,2065,2199,1.0,0.06093678944974989,0.9390632105502501,326,0.2514779445202365,0.6002728512960437,0.14824920418371987
1085,37081,1491,203,392,525,1288,1491,1.0,0.13615023474178403,0.863849765258216,574,0.26291079812206575,0.352112676056338,0.38497652582159625
1086,37081,1368,64,207,677,1304,1368,1.0,0.04678362573099415,0.9532163742690059,484,0.1513157894736842,0.49488304093567254,0.3538011695906433
1087,37081,1771,280,441,812,1491,1771,1.0,0.15810276679841898,0.841897233201581,518,0.2490118577075099,0.45849802371541504,0.2924901185770751
1088,37081,1398,988,855,121,410,1398,1.0,0.7067238912732475,0.2932761087267525,422,0.6115879828326181,0.08655221745350501,0.30185979971387694
1089,37081,2200,474,666,658,1726,2200,1.0,0.21545454545454545,0.7845454545454545,876,0.30272727272727273,0.2990909090909091,0.3981818181818182
1090,37081,2728,178,712,1638,2550,2728,1.0,0.06524926686217009,0.9347507331378299,378,0.26099706744868034,0.6004398826979472,0.13856304985337242
1091,37081,2961,151,644,1663,2810,2961,1.0,0.050996285038838234,0.9490037149611618,654,0.21749408983451538,0.5616345829111786,0.22087132725430597
1092,37081,2892,132,672,1845,2760,2892,1.0,0.04564315352697095,0.9543568464730291,375,0.23236514522821577,0.6379668049792531,0.12966804979253113
1093,37081,1263,50,160,775,1213,1263,1.0,0.0395882818685669,0.9604117181314331,328,0.12668250197941408,0.613618368962787,0.2596991290577989
1094,37081,2091,533,625,827,1558,2091,1.0,0.2549019607843137,0.7450980392156863,639,0.29890004782400764,0.39550454328072693,0.30559540889526543
1095,37081,3748,527,963,1818,3221,3748,1.0,0.14060832443970117,0.8593916755602988,967,0.25693703308431165,0.4850586979722519,0.2580042689434365
1096,37081,1756,60,418,1066,1696,1756,1.0,0.03416856492027335,0.9658314350797267,272,0.23804100227790434,0.6070615034168565,0.1548974943052392
1097,37081,1574,63,332,912,1511,1574,1.0,0.040025412960609914,0.9599745870393901,330,0.21092757306226176,0.579415501905972,0.2096569250317662
1098,37081,3666,189,701,2007,3477,3666,1.0,0.05155482815057283,0.9484451718494271,958,0.19121658483360612,0.5474631751227496,0.2613202400436443
1099,37081,2993,1472,1309,357,1521,2993,1.0,0.49181423321082524,0.5081857667891747,1327,0.43735382559305047,0.11927831607083195,0.4433678583361176
1100,37081,1607,611,604,258,996,1607,1.0,0.3802115743621655,0.6197884256378344,745,0.3758556316116988,0.16054760423148726,0.46359676415681395
1101,37081,3006,561,989,859,2445,3006,1.0,0.18662674650698602,0.8133732534930139,1158,0.3290086493679308,0.2857618097139055,0.3852295409181637
1102,37081,1108,186,289,346,922,1108,1.0,0.16787003610108303,0.8321299638989169,473,0.2608303249097473,0.31227436823104693,0.4268953068592058
1103,37081,2510,1169,1050,284,1341,2510,1.0,0.4657370517928287,0.5342629482071714,1176,0.41832669322709165,0.11314741035856574,0.4685258964143426
1104,37081,1901,693,778,475,1208,1901,1.0,0.3645449763282483,0.6354550236717517,648,0.40925828511309836,0.24986849026827984,0.3408732246186218
1105,37081,2063,127,477,1200,1936,2063,1.0,0.06156083373727581,0.9384391662627242,386,0.23121667474551624,0.58167716917111,0.18710615608337372
1106,37081,1737,404,419,443,1333,1737,1.0,0.23258491652274035,0.7674150834772596,875,0.24122049510650548,0.25503742084052966,0.5037420840529648
1107,37081,1624,240,418,636,1384,1624,1.0,0.1477832512315271,0.8522167487684729,570,0.25738916256157635,0.3916256157635468,0.35098522167487683
1108,37081,2665,94,353,1345,2571,2665,1.0,0.03527204502814259,0.9647279549718574,967,0.1324577861163227,0.5046904315196998,0.36285178236397747
1109,37081,2318,928,1060,563,1390,2318,1.0,0.4003451251078516,0.5996548748921484,695,0.457290767903365,0.24288179465056084,0.2998274374460742
1110,37081,1162,146,331,529,1016,1162,1.0,0.12564543889845095,0.8743545611015491,302,0.2848537005163511,0.45524956970740105,0.25989672977624784
1111,37081,2656,331,796,1279,2325,2656,1.0,0.12462349397590361,0.8753765060240963,581,0.2996987951807229,0.4815512048192771,0.21875
1112,37081,1591,330,463,472,1261,1591,1.0,0.20741671904462602,0.792583280955374,656,0.29101194217473286,0.29666876178504087,0.41231929604022627
1113,37081,1360,55,297,803,1305,1360,1.0,0.04044117647058824,0.9595588235294118,260,0.21838235294117647,0.5904411764705882,0.19117647058823528
1114,37081,2286,360,683,1222,1926,2286,1.0,0.15748031496062992,0.84251968503937,381,0.2987751531058618,0.5345581802274716,0.16666666666666666
1115,37081,2400,1630,1492,227,770,2400,1.0,0.6791666666666667,0.32083333333333336,681,0.6216666666666667,0.09458333333333334,0.28375
1116,37081,1748,117,460,1027,1631,1748,1.0,0.06693363844393593,0.933066361556064,261,0.2631578947368421,0.5875286041189931,0.14931350114416475
1117,37081,1601,183,373,712,1418,1601,1.0,0.11430356027482823,0.8856964397251718,516,0.23297938788257339,0.4447220487195503,0.3222985633978763
1118,37081,1626,216,577,781,1410,1626,1.0,0.13284132841328414,0.8671586715867159,268,0.3548585485854859,0.48031980319803197,0.16482164821648215
1119,37081,2068,1188,1145,270,880,2068,1.0,0.574468085106383,0.425531914893617,653,0.5536750483558994,0.13056092843326886,0.31576402321083175
1120,37081,3654,1860,1989,765,1794,3654,1.0,0.5090311986863711,0.4909688013136289,900,0.5443349753694581,0.20935960591133004,0.24630541871921183
1121,37081,1860,870,852,235,990,1860,1.0,0.46774193548387094,0.532258064516129,773,0.45806451612903226,0.12634408602150538,0.41559139784946236
1122,37081,1863,261,631,835,1602,1863,1.0,0.14009661835748793,0.8599033816425121,397,0.33870101986044016,0.4482018250134192,0.21309715512614064
1123,37081,1858,273,586,885,1585,1858,1.0,0.14693218514531756,0.8530678148546824,387,0.3153928955866523,0.47631862217438103,0.20828848223896662
1124,37081,3276,2071,1675,146,1205,3276,1.0,0.6321733821733821,0.36782661782661785,1455,0.5112942612942613,0.04456654456654457,0.4441391941391941
1125,37081,3258,2421,1978,126,837,3258,1.0,0.7430939226519337,0.2569060773480663,1154,0.6071209330877839,0.03867403314917127,0.3542050337630448
1126,37081,2858,694,1099,668,2164,2858,1.0,0.24282715185444367,0.7571728481455563,1091,0.38453463960811757,0.23372988103568929,0.3817354793561931
1127,37081,2451,491,931,886,1960,2451,1.0,0.20032639738882088,0.7996736026111791,634,0.3798449612403101,0.36148510811913503,0.2586699306405549
1128,37081,2101,858,963,274,1243,2101,1.0,0.4083769633507853,0.5916230366492147,864,0.4583531651594479,0.13041408852927178,0.4112327463112803
1129,37081,2300,342,686,1031,1958,2300,1.0,0.14869565217391303,0.851304347826087,583,0.2982608695652174,0.4482608695652174,0.2534782608695652
1130,37081,1852,1573,1239,68,279,1852,1.0,0.8493520518358532,0.15064794816414687,545,0.6690064794816415,0.0367170626349892,0.2942764578833693
1131,37081,2191,1016,1103,228,1175,2191,1.0,0.4637151985394797,0.5362848014605203,860,0.5034230944774076,0.10406207211319032,0.3925148334094021
1132,37081,3114,1128,956,325,1986,3114,1.0,0.3622350674373796,0.6377649325626205,1833,0.30700064226075785,0.10436737315350032,0.5886319845857418
1133,37081,2715,1875,1436,126,840,2715,1.0,0.6906077348066298,0.30939226519337015,1153,0.5289134438305709,0.04640883977900553,0.42467771639042357
1134,37081,2645,1166,1190,286,1479,2645,1.0,0.44083175803402647,0.5591682419659736,1169,0.4499054820415879,0.10812854442344046,0.44196597353497163
1135,37081,4195,539,1241,1679,3656,4195,1.0,0.12848629320619787,0.8715137067938021,1275,0.29582836710369487,0.40023837902264603,0.3039332538736591
1136,37081,3201,429,950,1734,2772,3201,1.0,0.13402061855670103,0.865979381443299,517,0.29678225554514215,0.5417057169634489,0.16151202749140894
1137,37081,4151,1272,1534,952,2879,4151,1.0,0.3064321850156589,0.6935678149843412,1665,0.36954950614309806,0.22934232715008432,0.40110816670681765
1138,37081,1688,383,636,382,1305,1688,1.0,0.2268957345971564,0.7731042654028436,670,0.3767772511848341,0.22630331753554503,0.39691943127962087
1139,37081,3217,1995,2299,421,1222,3217,1.0,0.6201429903636929,0.37985700963630714,497,0.7146409698476842,0.130867267640659,0.15449176251165683
1140,37081,1694,1565,1263,12,129,1694,1.0,0.9238488783943329,0.07615112160566706,419,0.7455726092089728,0.0070838252656434475,0.2473435655253837
1141,37081,1814,348,587,724,1466,1814,1.0,0.1918412348401323,0.8081587651598677,503,0.3235942668136714,0.39911797133406834,0.2772877618522602
1142,37081,2466,297,745,1009,2169,2466,1.0,0.12043795620437957,0.8795620437956204,712,0.30210867802108676,0.4091646390916464,0.28872668288726683
1143,37081,4182,1790,1712,363,2392,4182,1.0,0.42802486848397897,0.5719751315160211,2107,0.40937350549976087,0.08680057388809183,0.5038259206121473
1144,37081,2391,802,886,394,1589,2391,1.0,0.3354245085738185,0.6645754914261816,1111,0.3705562526139691,0.16478460895023003,0.4646591384358009
1145,37081,2089,1974,1784,17,115,2089,1.0,0.9449497367161321,0.05505026328386788,288,0.8539971278123504,0.008137865007180469,0.13786500718046912
1146,37083,456,265,159,114,191,456,1.0,0.581140350877193,0.41885964912280704,183,0.34868421052631576,0.25,0.40131578947368424
1147,37083,404,272,202,64,132,404,1.0,0.6732673267326733,0.32673267326732675,138,0.5,0.15841584158415842,0.3415841584158416
1148,37083,1388,1156,873,90,232,1388,1.0,0.8328530259365994,0.16714697406340057,425,0.6289625360230547,0.06484149855907781,0.3061959654178674
1149,37083,1821,1570,1091,102,251,1821,1.0,0.8621636463481603,0.13783635365183966,628,0.599121361889072,0.05601317957166392,0.34486545853926415
1150,37083,1251,935,676,126,316,1251,1.0,0.7474020783373302,0.25259792166266987,449,0.5403677058353318,0.10071942446043165,0.35891286970423664
1151,37083,1416,531,416,452,885,1416,1.0,0.375,0.625,548,0.2937853107344633,0.3192090395480226,0.3870056497175141
1152,37083,2413,1696,769,202,717,2413,1.0,0.7028595109821799,0.29714048901782014,1442,0.3186904268545379,0.08371322005801907,0.597596353087443
1153,37083,2515,1100,1461,98,1415,2515,1.0,0.43737574552683894,0.562624254473161,956,0.5809145129224652,0.0389662027833002,0.3801192842942346
1154,37083,1724,1143,910,245,581,1724,1.0,0.6629930394431555,0.33700696055684454,569,0.5278422273781903,0.14211136890951276,0.330046403712297
1155,37083,1591,415,409,641,1176,1591,1.0,0.2608422375864236,0.7391577624135763,541,0.257071024512885,0.40289126335637965,0.34003771213073536
1156,37083,1369,1112,977,88,257,1369,1.0,0.8122717311906501,0.1877282688093499,304,0.7136596055514974,0.06428049671292914,0.2220598977355734
1157,37083,467,230,244,133,237,467,1.0,0.4925053533190578,0.5074946466809421,90,0.5224839400428265,0.284796573875803,0.19271948608137046
1158,37083,1071,343,231,331,728,1071,1.0,0.3202614379084967,0.6797385620915033,509,0.21568627450980393,0.30905695611577966,0.4752567693744164
1159,37083,2804,784,728,1093,2020,2804,1.0,0.2796005706134094,0.7203994293865906,983,0.25962910128388017,0.3898002853067047,0.35057061340941514
1160,37083,2725,864,714,980,1861,2725,1.0,0.31706422018348623,0.6829357798165138,1031,0.2620183486238532,0.3596330275229358,0.378348623853211
1161,37083,503,108,100,103,395,503,1.0,0.2147117296222664,0.7852882703777336,300,0.1988071570576541,0.2047713717693837,0.5964214711729622
1162,37083,1211,137,219,486,1074,1211,1.0,0.11312964492155243,0.8868703550784476,506,0.18084227910817507,0.40132122213047067,0.41783649876135426
1163,37083,1008,77,185,510,931,1008,1.0,0.0763888888888889,0.9236111111111112,313,0.18353174603174602,0.5059523809523809,0.310515873015873
1164,37083,1134,271,255,390,863,1134,1.0,0.23897707231040563,0.7610229276895943,489,0.22486772486772486,0.3439153439153439,0.4312169312169312
1165,37083,1076,145,194,388,931,1076,1.0,0.13475836431226765,0.8652416356877324,494,0.18029739776951673,0.36059479553903345,0.4591078066914498
1166,37083,1403,867,635,162,536,1403,1.0,0.6179615110477548,0.3820384889522452,606,0.45260156806842483,0.11546685673556664,0.43193157519600855
1167,37083,1349,554,397,323,795,1349,1.0,0.4106745737583395,0.5893254262416605,629,0.29429206819866566,0.23943661971830985,0.46627131208302447
1168,37083,3076,1808,1442,491,1268,3076,1.0,0.58777633289987,0.41222366710013003,1143,0.4687906371911573,0.15962288686605983,0.3715864759427828
1169,37083,1650,1513,1048,61,137,1650,1.0,0.916969696969697,0.08303030303030302,541,0.6351515151515151,0.03696969696969697,0.3278787878787879
1170,37083,1256,560,341,371,696,1256,1.0,0.445859872611465,0.554140127388535,544,0.2714968152866242,0.29538216560509556,0.43312101910828027
1171,37083,1098,826,602,69,272,1098,1.0,0.7522768670309654,0.24772313296903462,427,0.5482695810564663,0.06284153005464481,0.3888888888888889
1172,37083,629,359,252,118,270,629,1.0,0.5707472178060413,0.4292527821939587,259,0.40063593004769477,0.1875993640699523,0.4117647058823529
1173,37083,2402,1550,1147,350,852,2402,1.0,0.6452955870108243,0.3547044129891757,905,0.47751873438801,0.14571190674437967,0.3767693588676103
1174,37083,539,299,112,96,240,539,1.0,0.5547309833024119,0.4452690166975881,331,0.2077922077922078,0.17810760667903525,0.614100185528757
1175,37083,324,255,175,31,69,324,1.0,0.7870370370370371,0.21296296296296297,118,0.5401234567901234,0.09567901234567901,0.36419753086419754
1176,37085,2829,1380,1196,667,1449,2829,1.0,0.4878048780487805,0.5121951219512195,966,0.42276422764227645,0.23577235772357724,0.34146341463414637
1177,37085,7938,910,1199,2893,7028,7938,1.0,0.1146384479717813,0.8853615520282186,3846,0.15104560342655582,0.36444948349710254,0.48450491307634164
1178,37085,6429,1020,1255,1983,5409,6429,1.0,0.15865608959402708,0.8413439104059729,3191,0.19520920827500388,0.30844610359309377,0.4963446881319023
1179,37085,4317,1737,1342,1215,2580,4317,1.0,0.40236275191104937,0.5976372480889507,1760,0.3108640259439426,0.28144544822793605,0.4076905258281214
1180,37085,5648,1387,1239,2117,4261,5648,1.0,0.24557365439093484,0.7544263456090652,2292,0.21936968838526913,0.3748229461756374,0.40580736543909346
1181,37085,8885,1740,1912,2564,7145,8885,1.0,0.19583567810917277,0.8041643218908272,4409,0.2151941474395048,0.28857625211029825,0.496229600450197
1182,37085,7594,1058,1507,2655,6536,7594,1.0,0.13932051619699762,0.8606794838030024,3432,0.19844614169080854,0.3496181195680801,0.4519357387411114
1183,37085,4620,630,843,1932,3990,4620,1.0,0.13636363636363635,0.8636363636363636,1845,0.18246753246753247,0.41818181818181815,0.39935064935064934
1184,37085,3944,1538,994,708,2406,3944,1.0,0.38995943204868155,0.6100405679513184,2242,0.25202839756592293,0.1795131845841785,0.5684584178498986
1185,37085,7010,1631,1545,1567,5379,7010,1.0,0.2326676176890157,0.7673323823109843,3898,0.22039942938659057,0.22353780313837376,0.5560627674750357
1186,37085,6218,840,858,1540,5378,6218,1.0,0.13509166934705694,0.864908330652943,3820,0.1379864908330653,0.24766806046960438,0.6143454486973303
1187,37085,11860,2206,2423,3209,9654,11860,1.0,0.18600337268128161,0.8139966273187184,6228,0.20430016863406408,0.2705733558178752,0.5251264755480607
1188,37085,5559,560,1018,2515,4999,5559,1.0,0.10073754272351142,0.8992624572764886,2026,0.18312646159381182,0.45241949991005576,0.3644540384961324
1189,37087,29,0,8,13,29,29,1.0,0.0,1.0,8,0.27586206896551724,0.4482758620689655,0.27586206896551724
1190,37087,2411,21,571,752,2390,2411,1.0,0.008710078805474907,0.9912899211945251,1088,0.23683119037743675,0.31190377436748234,0.4512650352550809
1191,37087,3260,17,897,1286,3243,3260,1.0,0.005214723926380368,0.9947852760736197,1077,0.27515337423312886,0.39447852760736196,0.3303680981595092
1192,37087,889,1,277,312,888,889,1.0,0.0011248593925759281,0.9988751406074241,300,0.31158605174353204,0.35095613048368957,0.3374578177727784
1193,37087,1370,2,312,348,1368,1370,1.0,0.00145985401459854,0.9985401459854014,710,0.22773722627737225,0.25401459854014596,0.5182481751824818
1194,37087,3319,11,831,1032,3308,3319,1.0,0.0033142512805061767,0.9966857487194938,1456,0.2503766194636939,0.3109370292256704,0.4386863513106357
1195,37087,1962,75,598,605,1887,1962,1.0,0.0382262996941896,0.9617737003058104,759,0.30479102956167176,0.30835881753312944,0.38685015290519875
1196,37087,2199,38,685,730,2161,2199,1.0,0.017280582082764895,0.9827194179172352,784,0.31150522964984084,0.33196907685311505,0.3565256934970441
1197,37087,326,0,97,80,326,326,1.0,0.0,1.0,149,0.29754601226993865,0.24539877300613497,0.4570552147239264
1198,37087,1839,14,466,527,1825,1839,1.0,0.0076128330614464385,0.9923871669385536,846,0.25339858618814576,0.2865687873844481,0.4600326264274062
1199,37087,1744,2,626,610,1742,1744,1.0,0.0011467889908256881,0.9988532110091743,508,0.35894495412844035,0.34977064220183485,0.29128440366972475
1200,37087,2151,4,581,667,2147,2151,1.0,0.0018596001859600185,0.99814039981404,903,0.2701069270106927,0.3100883310088331,0.4198047419804742
1201,37087,1358,3,232,519,1355,1358,1.0,0.0022091310751104565,0.9977908689248896,607,0.17083946980854198,0.38217967599410896,0.44698085419734906
1202,37087,1483,6,316,498,1477,1483,1.0,0.004045853000674309,0.9959541469993257,669,0.21308159136884694,0.33580579905596764,0.45111260957518545
1203,37087,2972,7,541,1157,2965,2972,1.0,0.0023553162853297443,0.9976446837146703,1274,0.18203230148048452,0.389300134589502,0.4286675639300135
1204,37087,824,1,197,263,823,824,1.0,0.0012135922330097086,0.9987864077669902,364,0.23907766990291263,0.3191747572815534,0.441747572815534
1205,37087,1288,2,244,500,1286,1288,1.0,0.0015527950310559005,0.9984472049689441,544,0.18944099378881987,0.38819875776397517,0.422360248447205
1206,37087,2633,29,598,837,2604,2633,1.0,0.011014052411697683,0.9889859475883023,1198,0.2271173566274212,0.31788834029624,0.45499430307633876
1207,37087,1639,6,514,507,1633,1639,1.0,0.0036607687614399025,0.99633923123856,618,0.3136058572300183,0.30933496034167174,0.37705918242830994
1208,37087,1925,147,549,541,1778,1925,1.0,0.07636363636363637,0.9236363636363636,835,0.28519480519480517,0.28103896103896103,0.43376623376623374
1209,37087,411,1,61,202,410,411,1.0,0.0024330900243309003,0.9975669099756691,148,0.14841849148418493,0.49148418491484186,0.36009732360097324
1210,37087,2150,19,461,726,2131,2150,1.0,0.008837209302325582,0.9911627906976744,963,0.2144186046511628,0.33767441860465114,0.44790697674418606
1211,37087,1265,1,240,521,1264,1265,1.0,0.0007905138339920949,0.9992094861660079,504,0.18972332015810275,0.41185770750988143,0.3984189723320158
1212,37087,1417,37,299,241,1380,1417,1.0,0.02611150317572336,0.9738884968242767,877,0.21100917431192662,0.17007762879322513,0.6189131968948482
1213,37087,2293,3,598,729,2290,2293,1.0,0.0013083296990841692,0.9986916703009159,966,0.2607937200174444,0.31792411687745314,0.42128216310510247
1214,37087,1389,1,431,547,1388,1389,1.0,0.0007199424046076314,0.9992800575953924,411,0.3102951763858891,0.3938084953203744,0.2958963282937365
1215,37087,1765,8,339,633,1757,1765,1.0,0.004532577903682719,0.9954674220963173,793,0.19206798866855523,0.35864022662889516,0.4492917847025496
1216,37087,989,28,220,172,961,989,1.0,0.028311425682507583,0.9716885743174924,597,0.2224469160768453,0.17391304347826086,0.6036400404448938
1217,37087,201,0,44,78,201,201,1.0,0.0,1.0,79,0.21890547263681592,0.3880597014925373,0.39303482587064675
1218,37089,3189,76,732,1406,3113,3189,1.0,0.02383192223267482,0.9761680777673252,1051,0.2295390404515522,0.4408905613044842,0.3295703982439636
1219,37089,2899,14,696,1477,2885,2899,1.0,0.004829251466022766,0.9951707485339772,726,0.24008278716798895,0.5094860296654019,0.2504311831666092
1220,37089,3755,50,596,1336,3705,3755,1.0,0.013315579227696404,0.9866844207723036,1823,0.15872170439414116,0.3557922769640479,0.4854860186418109
1221,37089,904,9,246,332,895,904,1.0,0.00995575221238938,0.9900442477876106,326,0.2721238938053097,0.3672566371681416,0.3606194690265487
1222,37089,3056,272,825,738,2784,3056,1.0,0.08900523560209424,0.9109947643979057,1493,0.2699607329842932,0.24149214659685864,0.4885471204188482
1223,37089,4413,164,1077,1553,4249,4413,1.0,0.03716292771357353,0.9628370722864265,1783,0.24405166553365057,0.3519147971901201,0.4040335372762293
1224,37089,2922,71,463,999,2851,2922,1.0,0.0242984257357974,0.9757015742642026,1460,0.15845311430527037,0.34188911704312114,0.4996577686516085
1225,37089,3073,17,457,1345,3056,3073,1.0,0.005532053368044257,0.9944679466319557,1271,0.1487146111291897,0.4376830458835015,0.4136023429873088
1226,37089,2464,44,485,1058,2420,2464,1.0,0.017857142857142856,0.9821428571428571,921,0.19683441558441558,0.42938311688311687,0.3737824675324675
1227,37089,1860,53,268,504,1807,1860,1.0,0.02849462365591398,0.9715053763440861,1088,0.14408602150537633,0.2709677419354839,0.5849462365591398
1228,37089,2514,112,800,844,2402,2514,1.0,0.04455051710421639,0.9554494828957836,870,0.31821797931583135,0.33571996817820204,0.3460620525059666
1229,37089,925,166,276,332,759,925,1.0,0.17945945945945946,0.8205405405405405,317,0.2983783783783784,0.3589189189189189,0.3427027027027027
1230,37089,2630,6,413,1243,2624,2630,1.0,0.0022813688212927757,0.9977186311787072,974,0.15703422053231939,0.4726235741444867,0.3703422053231939
1231,37089,2750,46,572,1030,2704,2750,1.0,0.016727272727272726,0.9832727272727273,1148,0.208,0.37454545454545457,0.41745454545454547
1232,37089,2972,62,652,1297,2910,2972,1.0,0.02086137281292059,0.9791386271870794,1023,0.2193808882907133,0.4364064602960969,0.3442126514131898
1233,37089,2600,22,564,1193,2578,2600,1.0,0.008461538461538461,0.9915384615384616,843,0.2169230769230769,0.45884615384615385,0.3242307692307692
1234,37089,2636,6,839,1487,2630,2636,1.0,0.002276176024279211,0.9977238239757208,310,0.3182852807283763,0.5641122913505311,0.11760242792109256
1235,37089,3758,27,772,1675,3731,3758,1.0,0.007184672698243746,0.9928153273017563,1311,0.2054284193720064,0.4457158062799361,0.3488557743480575
1236,37089,1257,7,250,559,1250,1257,1.0,0.005568814638027049,0.994431185361973,448,0.19888623707239458,0.4447096260938743,0.3564041368337311
1237,37089,1825,22,563,925,1803,1825,1.0,0.012054794520547946,0.9879452054794521,337,0.3084931506849315,0.5068493150684932,0.18465753424657536
1238,37089,2234,68,502,755,2166,2234,1.0,0.03043867502238138,0.9695613249776186,977,0.22470904207699194,0.337958818263205,0.43733213965980305
1239,37089,2327,14,570,1087,2313,2327,1.0,0.006016330038676407,0.9939836699613236,670,0.24495058014611087,0.4671250537172325,0.2879243661366566
1240,37089,2169,29,485,845,2140,2169,1.0,0.013370216689718764,0.9866297833102813,839,0.2236053480866759,0.3895804518211157,0.3868142000922084
1241,37089,2046,20,559,936,2026,2046,1.0,0.009775171065493646,0.9902248289345064,551,0.2732160312805474,0.4574780058651026,0.26930596285434993
1242,37089,1821,27,564,770,1794,1821,1.0,0.014827018121911038,0.985172981878089,487,0.30971993410214166,0.4228445908841296,0.2674354750137287
1243,37089,1741,30,358,604,1711,1741,1.0,0.01723147616312464,0.9827685238368754,779,0.20562894887995406,0.3469270534175761,0.44744399770246984
1244,37089,991,1,225,382,990,991,1.0,0.0010090817356205853,0.9989909182643795,384,0.22704339051463168,0.3854692230070636,0.3874873864783047
1245,37089,3097,121,535,979,2976,3097,1.0,0.039070067807555696,0.9609299321924443,1583,0.17274782047142395,0.316112366806587,0.511139812721989
1246,37089,1479,62,280,577,1417,1479,1.0,0.04192021636240703,0.9580797836375929,622,0.18931710615280595,0.3901284651791751,0.42055442866801895
1247,37089,1467,52,272,444,1415,1467,1.0,0.0354464894342195,0.9645535105657805,751,0.18541240627130198,0.30265848670756645,0.5119291070211316
1248,37089,3481,417,963,963,3064,3481,1.0,0.11979316288422867,0.8802068371157713,1555,0.276644642344154,0.276644642344154,0.44671071531169204
1249,37089,4813,59,652,1590,4754,4813,1.0,0.012258466652815292,0.9877415333471847,2571,0.13546644504467067,0.33035528776231043,0.5341782671930189
1250,37089,2180,129,490,652,2051,2180,1.0,0.05917431192660551,0.9408256880733945,1038,0.22477064220183487,0.29908256880733947,0.4761467889908257
1251,37089,2533,45,641,1077,2488,2533,1.0,0.017765495459928938,0.9822345045400711,815,0.25305961310698777,0.42518752467429927,0.32175286221871296
1252,37091,517,198,203,125,319,517,1.0,0.3829787234042553,0.6170212765957447,189,0.39264990328820115,0.24177949709864605,0.3655705996131528
1253,37091,692,475,380,92,217,692,1.0,0.6864161849710982,0.31358381502890176,220,0.5491329479768786,0.1329479768786127,0.3179190751445087
1254,37091,2695,1714,721,186,981,2695,1.0,0.6359925788497217,0.3640074211502783,1788,0.2675324675324675,0.06901669758812616,0.6634508348794063
1255,37091,1163,658,358,193,505,1163,1.0,0.5657781599312124,0.4342218400687876,612,0.30782459157351677,0.16595012897678418,0.5262252794496991
1256,37091,1461,888,658,219,573,1461,1.0,0.6078028747433265,0.3921971252566735,584,0.45037645448323066,0.14989733059548255,0.3997262149212868
1257,37091,529,415,279,36,114,529,1.0,0.7844990548204159,0.21550094517958412,214,0.5274102079395085,0.06805293005671077,0.4045368620037807
1258,37091,3348,2036,1508,460,1312,3348,1.0,0.6081242532855436,0.3918757467144564,1380,0.45041816009557945,0.13739545997610514,0.4121863799283154
1259,37091,2412,1239,974,447,1173,2412,1.0,0.513681592039801,0.486318407960199,991,0.40381426202321724,0.1853233830845771,0.41086235489220563
1260,37091,1036,543,383,222,493,1036,1.0,0.5241312741312741,0.47586872586872586,431,0.3696911196911197,0.21428571428571427,0.416023166023166
1261,37091,2548,1230,810,563,1318,2548,1.0,0.4827315541601256,0.5172684458398744,1175,0.3178963893249607,0.22095761381475668,0.46114599686028257
1262,37091,1442,1281,1035,39,161,1442,1.0,0.8883495145631068,0.11165048543689321,368,0.717753120665742,0.027045769764216365,0.2552011095700416
1263,37091,924,533,416,171,391,924,1.0,0.5768398268398268,0.4231601731601732,337,0.45021645021645024,0.18506493506493507,0.3647186147186147
1264,37091,705,127,118,254,578,705,1.0,0.18014184397163122,0.8198581560283688,333,0.1673758865248227,0.36028368794326243,0.4723404255319149
1265,37093,518,125,107,69,393,518,1.0,0.2413127413127413,0.7586872586872587,342,0.20656370656370657,0.13320463320463322,0.6602316602316602
1266,37093,2676,652,800,324,2024,2676,1.0,0.2436472346786248,0.7563527653213752,1552,0.29895366218236175,0.1210762331838565,0.5799701046337817
1267,37093,3886,1670,1413,460,2216,3886,1.0,0.4297478126608338,0.5702521873391663,2013,0.36361296963458567,0.11837364899639732,0.518013381369017
1268,37093,1151,453,339,263,698,1151,1.0,0.3935708079930495,0.6064291920069504,549,0.2945264986967854,0.22849695916594265,0.4769765421372719
1269,37093,10292,3134,2930,2232,7158,10292,1.0,0.3045083560046638,0.6954916439953361,5130,0.2846871356393315,0.21686746987951808,0.4984453944811504
1270,37093,1986,694,501,467,1292,1986,1.0,0.34944612286002014,0.6505538771399798,1018,0.25226586102719034,0.2351460221550856,0.5125881168177241
1271,37093,1477,328,333,472,1149,1477,1.0,0.22207176709546378,0.7779282329045363,672,0.22545700744752878,0.3195666892349357,0.4549763033175355
1272,37093,4008,811,888,1239,3197,4008,1.0,0.20234530938123751,0.7976546906187625,1881,0.2215568862275449,0.3091317365269461,0.469311377245509
1273,37093,1147,420,433,147,727,1147,1.0,0.36617262423714037,0.6338273757628596,567,0.37750653879686136,0.12816041848299914,0.4943330427201395
1274,37093,1761,811,740,349,950,1761,1.0,0.4605337876206701,0.5394662123793299,672,0.4202157864849517,0.19818285065303803,0.38160136286201024
1275,37093,742,685,616,7,57,742,1.0,0.9231805929919138,0.07681940700808626,119,0.8301886792452831,0.009433962264150943,0.16037735849056603
1276,37093,2036,886,673,461,1150,2036,1.0,0.4351669941060904,0.5648330058939096,902,0.3305500982318271,0.22642436149312378,0.4430255402750491
1277,37093,1087,359,303,329,728,1087,1.0,0.33026678932842685,0.6697332106715731,455,0.27874885004599814,0.30266789328426863,0.41858325666973323
1278,37095,421,20,23,178,401,421,1.0,0.047505938242280284,0.9524940617577197,220,0.05463182897862233,0.42280285035629456,0.5225653206650831
1279,37095,751,10,336,181,741,751,1.0,0.013315579227696404,0.9866844207723036,234,0.4474034620505992,0.24101198402130491,0.31158455392809586
1280,37095,761,274,224,171,487,761,1.0,0.3600525624178712,0.6399474375821288,366,0.2943495400788436,0.22470433639947437,0.480946123521682
1281,37095,1109,635,110,143,474,1109,1.0,0.5725879170423805,0.42741208295761945,856,0.09918845807033363,0.12894499549143373,0.7718665464382326
1282,37095,445,160,103,156,285,445,1.0,0.3595505617977528,0.6404494382022472,186,0.23146067415730337,0.350561797752809,0.41797752808988764
1283,37095,640,172,150,229,468,640,1.0,0.26875,0.73125,261,0.234375,0.3578125,0.4078125
1284,37095,607,283,217,135,324,607,1.0,0.46622734761120266,0.5337726523887973,255,0.357495881383855,0.22240527182866557,0.4200988467874794
1285,37097,2911,367,586,1168,2544,2911,1.0,0.12607351425626934,0.8739264857437307,1157,0.2013053933356235,0.40123668842322224,0.39745791824115423
1286,37097,5249,360,976,2590,4889,5249,1.0,0.06858449228424462,0.9314155077157554,1683,0.18594017908172986,0.49342731948942653,0.3206325014288436
1287,37097,1402,30,186,710,1372,1402,1.0,0.021398002853067047,0.978601997146933,506,0.1326676176890157,0.5064194008559201,0.3609129814550642
1288,37097,4825,425,890,1889,4400,4825,1.0,0.08808290155440414,0.9119170984455959,2046,0.1844559585492228,0.3915025906735751,0.42404145077720207
1289,37097,2006,84,246,1003,1922,2006,1.0,0.04187437686939183,0.9581256231306082,757,0.1226321036889332,0.5,0.3773678963110668
1290,37097,2911,381,559,979,2530,2911,1.0,0.1308828581243559,0.8691171418756442,1373,0.19203023016145654,0.3363105462040536,0.47165922363448987
1291,37097,4102,121,798,1919,3981,4102,1.0,0.029497805948317895,0.9705021940516821,1385,0.1945392491467577,0.46782057532910776,0.33764017552413456
1292,37097,1406,106,175,594,1300,1406,1.0,0.07539118065433854,0.9246088193456614,637,0.12446657183499289,0.422475106685633,0.45305832147937414
1293,37097,5253,398,806,2263,4855,5253,1.0,0.07576622882162574,0.9242337711783742,2184,0.15343613173424708,0.43080144679230914,0.4157624214734437
1294,37097,1671,36,182,808,1635,1671,1.0,0.02154398563734291,0.9784560143626571,681,0.10891681627767803,0.48354278874925194,0.40754039497307004
1295,37097,1295,4,163,646,1291,1295,1.0,0.003088803088803089,0.9969111969111969,486,0.12586872586872586,0.4988416988416988,0.3752895752895753
1296,37097,3566,334,578,1108,3232,3566,1.0,0.09366236679753225,0.9063376332024677,1880,0.16208637128435222,0.3107122826696579,0.5272013460459899
1297,37097,3415,218,482,1571,3197,3415,1.0,0.06383601756954611,0.9361639824304538,1362,0.1411420204978038,0.46002928257686676,0.3988286969253294
1298,37097,3695,1593,1457,781,2102,3695,1.0,0.4311231393775372,0.5688768606224628,1457,0.3943166441136671,0.21136671177266578,0.3943166441136671
1299,37097,4018,1771,1609,784,2247,4018,1.0,0.44076655052264807,0.5592334494773519,1625,0.4004479840716775,0.1951219512195122,0.4044300647088104
1300,37097,4273,667,1106,1551,3606,4273,1.0,0.15609641937748656,0.8439035806225135,1616,0.2588345424760122,0.3629768312660894,0.37818862625789845
1301,37097,3587,952,1199,957,2635,3587,1.0,0.26540284360189575,0.7345971563981043,1431,0.3342626149986061,0.26679676609980485,0.39894061890158905
1302,37097,3470,672,958,1179,2798,3470,1.0,0.1936599423631124,0.8063400576368877,1333,0.2760806916426513,0.33976945244956774,0.384149855907781
1303,37097,3401,170,528,1534,3231,3401,1.0,0.049985298441634816,0.9500147015583652,1339,0.15524845633637166,0.45104381064392823,0.3937077330197001
1304,37097,3447,706,932,995,2741,3447,1.0,0.20481578183928054,0.7951842181607195,1520,0.2703800406150276,0.2886568030171163,0.4409631563678561
1305,37097,5832,471,1390,2314,5361,5832,1.0,0.08076131687242798,0.9192386831275721,2128,0.23834019204389575,0.3967764060356653,0.36488340192043894
1306,37097,3806,50,702,2230,3756,3806,1.0,0.013137151865475564,0.9868628481345244,874,0.18444561219127692,0.5859169732002102,0.22963741460851286
1307,37097,7314,127,1497,4503,7187,7314,1.0,0.017363959529669126,0.9826360404703308,1314,0.20467596390484002,0.6156685808039376,0.17965545529122232
1308,37097,6582,309,1241,2615,6273,6582,1.0,0.04694621695533273,0.9530537830446673,2726,0.18854451534487998,0.3972956548161653,0.4141598298389547
1309,37097,6444,1098,1696,1975,5346,6444,1.0,0.17039106145251395,0.8296089385474861,2773,0.2631905648665425,0.3064866542520174,0.4303227808814401
1310,37097,5764,168,1169,3099,5596,5764,1.0,0.02914642609299098,0.970853573907009,1496,0.20281054823039557,0.53764746703678,0.2595419847328244
1311,37097,7675,772,1833,3130,6903,7675,1.0,0.10058631921824104,0.899413680781759,2712,0.23882736156351791,0.40781758957654723,0.35335504885993485
1312,37097,6855,622,1401,3363,6233,6855,1.0,0.09073668854850474,0.9092633114514953,2091,0.20437636761487965,0.4905908096280088,0.3050328227571116
1313,37097,2677,517,731,1041,2160,2677,1.0,0.19312663429211804,0.8068733657078819,905,0.2730668658946582,0.3888681359731042,0.33806499813223756
1314,37099,4553,22,911,806,4531,4553,1.0,0.004831978915001098,0.9951680210849989,2836,0.20008785416209093,0.17702613661322206,0.6228860092246871
1315,37099,1698,8,389,841,1690,1698,1.0,0.004711425206124852,0.9952885747938751,468,0.22909305064782096,0.49528857479387517,0.2756183745583039
1316,37099,1825,1,302,702,1824,1825,1.0,0.000547945205479452,0.9994520547945206,821,0.16547945205479453,0.38465753424657534,0.44986301369863013
1317,37099,1485,8,297,462,1477,1485,1.0,0.0053872053872053875,0.9946127946127946,726,0.2,0.3111111111111111,0.4888888888888889
1318,37099,1702,9,490,486,1693,1702,1.0,0.005287896592244419,0.9947121034077556,726,0.2878965922444183,0.28554641598119856,0.42655699177438305
1319,37099,1024,7,193,274,1017,1024,1.0,0.0068359375,0.9931640625,557,0.1884765625,0.267578125,0.5439453125
1320,37099,591,0,164,184,591,591,1.0,0.0,1.0,243,0.27749576988155666,0.311336717428088,0.41116751269035534
1321,37099,2159,21,690,557,2138,2159,1.0,0.009726725335803613,0.9902732746641963,912,0.31959240389069016,0.25798981009726724,0.4224177860120426
1322,37099,1186,1,288,433,1185,1186,1.0,0.0008431703204047217,0.9991568296795953,465,0.24283305227655985,0.3650927487352445,0.3920741989881956
1323,37099,6562,95,1904,1597,6467,6562,1.0,0.014477293508076805,0.9855227064919232,3061,0.29015544041450775,0.24337092349893324,0.46647363608655895
1324,37099,8698,507,1919,1330,8191,8698,1.0,0.058289261899287195,0.9417107381007128,5449,0.22062543113359392,0.1529087146470453,0.6264658542193607
1325,37099,1147,6,316,322,1141,1147,1.0,0.0052310374891020054,0.994768962510898,509,0.27550130775937226,0.2807323452484743,0.44376634699215345
1326,37099,518,1,100,175,517,518,1.0,0.0019305019305019305,0.9980694980694981,243,0.19305019305019305,0.33783783783783783,0.4691119691119691
1327,37101,3336,1255,1087,535,2081,3336,1.0,0.3761990407673861,0.6238009592326139,1714,0.32583932853717024,0.1603717026378897,0.5137889688249401
1328,37101,3100,994,950,529,2106,3100,1.0,0.32064516129032256,0.6793548387096774,1621,0.3064516129032258,0.1706451612903226,0.5229032258064517
1329,37101,3446,792,691,1139,2654,3446,1.0,0.2298316889146837,0.7701683110853164,1616,0.20052234474753336,0.3305281485780615,0.4689495066744051
1330,37101,4164,445,957,1963,3719,4164,1.0,0.1068683957732949,0.8931316042267051,1244,0.2298270893371758,0.47142170989433235,0.2987512007684918
1331,37101,1681,205,239,621,1476,1681,1.0,0.12195121951219512,0.8780487804878049,821,0.1421772754312909,0.36942296252230816,0.48839976204640095
1332,37101,3517,435,585,1407,3082,3517,1.0,0.12368495877168041,0.8763150412283196,1525,0.1663349445550185,0.4000568666477111,0.4336081887972704
1333,37101,3032,246,357,1326,2786,3032,1.0,0.08113456464379948,0.9188654353562006,1349,0.11774406332453825,0.43733509234828494,0.44492084432717677
1334,37101,3178,828,831,701,2350,3178,1.0,0.2605412208936438,0.7394587791063562,1646,0.2614852108244179,0.22057898049087477,0.5179358086847073
1335,37101,5521,1064,1344,1491,4457,5521,1.0,0.19271871037855462,0.8072812896214454,2686,0.24343416047817423,0.2700597717804746,0.4865060677413512
1336,37101,4314,593,910,1594,3721,4314,1.0,0.13745943439962913,0.8625405656003708,1810,0.21094112192860454,0.36949466852109414,0.4195642095503013
1337,37101,4766,907,1441,1648,3859,4766,1.0,0.1903063365505665,0.8096936634494335,1677,0.3023499790180445,0.3457826269408309,0.35186739404112466
1338,37101,2129,238,301,821,1891,2129,1.0,0.11178957256928135,0.8882104274307187,1007,0.14138093001409113,0.38562705495537813,0.4729920150305308
1339,37101,6596,836,1819,3150,5760,6596,1.0,0.12674348089751364,0.8732565191024864,1627,0.2757731958762887,0.47756215888417225,0.24666464523953913
1340,37101,2659,240,416,1204,2419,2659,1.0,0.09025949605114705,0.909740503948853,1039,0.15644979315532154,0.452801805189921,0.39074840165475744
1341,37101,4043,1039,888,1160,3004,4043,1.0,0.25698738560474893,0.743012614395251,1995,0.21963888201830323,0.2869156566905763,0.49344546129112044
1342,37101,1973,234,311,812,1739,1973,1.0,0.11860111505321845,0.8813988849467815,850,0.15762797769893563,0.41155600608210846,0.4308160162189559
1343,37101,2235,87,247,1055,2148,2235,1.0,0.038926174496644296,0.9610738255033557,933,0.11051454138702461,0.4720357941834452,0.4174496644295302
1344,37101,1312,214,229,544,1098,1312,1.0,0.16310975609756098,0.836890243902439,539,0.17454268292682926,0.4146341463414634,0.4108231707317073
1345,37101,2327,63,245,1120,2264,2327,1.0,0.027073485174043833,0.9729265148259562,962,0.10528577567683713,0.4813064030941126,0.4134078212290503
1346,37101,2305,305,357,727,2000,2305,1.0,0.13232104121475055,0.8676789587852495,1221,0.15488069414316702,0.3154013015184382,0.5297180043383948
1347,37101,2893,193,435,1151,2700,2893,1.0,0.06671275492568268,0.9332872450743174,1307,0.15036294503975112,0.3978568959557553,0.4517801590044936
1348,37101,1257,349,259,441,908,1257,1.0,0.27764518695306284,0.7223548130469372,557,0.2060461416070008,0.35083532219570407,0.44311853619729513
1349,37101,3120,367,483,1312,2753,3120,1.0,0.11762820512820513,0.8823717948717948,1325,0.1548076923076923,0.4205128205128205,0.42467948717948717
1350,37101,1424,273,270,531,1151,1424,1.0,0.19171348314606743,0.8082865168539326,623,0.1896067415730337,0.3728932584269663,0.4375
1351,37101,1503,114,135,624,1389,1503,1.0,0.07584830339321358,0.9241516966067864,744,0.08982035928143713,0.4151696606786427,0.49500998003992014
1352,37101,4290,293,886,2276,3997,4290,1.0,0.0682983682983683,0.9317016317016317,1128,0.20652680652680652,0.5305361305361306,0.2629370629370629
1353,37101,2793,280,584,1156,2513,2793,1.0,0.10025062656641603,0.899749373433584,1053,0.20909416398138203,0.4138918725384891,0.3770139634801289
1354,37101,5236,513,1549,3010,4723,5236,1.0,0.0979755538579068,0.9020244461420932,677,0.2958365164247517,0.5748663101604278,0.12929717341482047
1355,37101,6135,1352,2040,2030,4783,6135,1.0,0.22037489812550937,0.7796251018744906,2065,0.33251833740831294,0.33088834555827223,0.33659331703341483
1356,37101,4077,598,1264,1691,3479,4077,1.0,0.1466764778023056,0.8533235221976944,1122,0.3100318861908266,0.41476575913662006,0.27520235467255333
1357,37101,4463,468,1188,2123,3995,4463,1.0,0.10486220031369034,0.8951377996863097,1152,0.2661886623347524,0.47568899843154827,0.2581223392336993
1358,37101,2535,306,609,1142,2229,2535,1.0,0.12071005917159763,0.8792899408284024,784,0.24023668639053256,0.4504930966469428,0.30927021696252466
1359,37101,6742,621,1336,3006,6121,6742,1.0,0.0921091664194601,0.9078908335805399,2400,0.19816078315040048,0.44586176208840106,0.35597745476119846
1360,37101,3702,211,530,1713,3491,3702,1.0,0.056996218260399786,0.9430037817396002,1459,0.1431658562938952,0.4627228525121556,0.3941112911939492
1361,37101,2244,212,368,925,2032,2244,1.0,0.0944741532976827,0.9055258467023173,951,0.16399286987522282,0.41221033868092694,0.42379679144385024
1362,37101,985,45,108,468,940,985,1.0,0.04568527918781726,0.9543147208121827,409,0.10964467005076142,0.4751269035532995,0.4152284263959391
1363,37101,2875,669,831,1107,2206,2875,1.0,0.23269565217391305,0.7673043478260869,937,0.28904347826086957,0.38504347826086954,0.3259130434782609
1364,37103,822,249,198,280,573,822,1.0,0.3029197080291971,0.6970802919708029,344,0.24087591240875914,0.340632603406326,0.41849148418491483
1365,37103,521,61,67,296,460,521,1.0,0.11708253358925144,0.8829174664107485,158,0.12859884836852206,0.5681381957773513,0.30326295585412666
1366,37103,2102,676,662,809,1426,2102,1.0,0.32159847764034255,0.6784015223596574,631,0.3149381541389153,0.38487155090390107,0.30019029495718363
1367,37103,1566,611,520,395,955,1566,1.0,0.3901660280970626,0.6098339719029374,651,0.33205619412515963,0.25223499361430396,0.4157088122605364
1368,37103,1538,759,712,418,779,1538,1.0,0.49349804941482445,0.5065019505851756,408,0.46293888166449937,0.2717815344603381,0.26527958387516254
1369,37103,689,67,86,325,622,689,1.0,0.09724238026124818,0.9027576197387518,278,0.12481857764876633,0.4716981132075472,0.4034833091436865
1370,37103,707,101,107,314,606,707,1.0,0.14285714285714285,0.8571428571428571,286,0.15134370579915135,0.44413012729844414,0.4045261669024045
1371,37105,5063,1016,1281,1592,4047,5063,1.0,0.20067153861347028,0.7993284613865297,2190,0.25301204819277107,0.3144380801896109,0.432549871617618
1372,37105,8015,853,2002,3765,7162,8015,1.0,0.10642545227698066,0.8935745477230194,2248,0.2497816593886463,0.4697442295695571,0.28047411104179665
1373,37105,7643,1089,1716,2378,6554,7643,1.0,0.14248331806882114,0.8575166819311788,3549,0.2245191678660212,0.31113437132016225,0.4643464608138166
1374,37105,13299,4254,4042,2131,9045,13299,1.0,0.31987367471238437,0.6801263252876156,7126,0.3039326265132717,0.16023761185051508,0.5358297616362132
1375,37105,8986,1033,1760,3292,7953,8986,1.0,0.11495659915423993,0.88504340084576,3934,0.1958602270198086,0.36634765190296015,0.43779212107723126
1376,37107,945,119,100,402,826,945,1.0,0.1259259259259259,0.8740740740740741,443,0.10582010582010581,0.4253968253968254,0.4687830687830688
1377,37107,1324,123,142,581,1201,1324,1.0,0.09290030211480363,0.9070996978851964,601,0.10725075528700906,0.438821752265861,0.45392749244712993
1378,37107,3898,886,757,1437,3012,3898,1.0,0.22729604925602873,0.7727039507439712,1704,0.19420215495125706,0.3686505900461775,0.4371472550025654
1379,37107,1373,1230,744,20,143,1373,1.0,0.8958485069191552,0.10415149308084487,609,0.5418790968681719,0.014566642388929352,0.4435542607428988
1380,37107,1941,403,345,779,1538,1941,1.0,0.2076249356002061,0.7923750643997939,817,0.1777434312210201,0.4013395157135497,0.4209170530654302
1381,37107,1564,150,182,759,1414,1564,1.0,0.0959079283887468,0.9040920716112532,623,0.11636828644501279,0.4852941176470588,0.3983375959079284
1382,37107,4572,781,772,2232,3791,4572,1.0,0.17082239720034995,0.82917760279965,1568,0.16885389326334208,0.4881889763779528,0.3429571303587052
1383,37107,4381,1772,1490,1333,2609,4381,1.0,0.4044738644145172,0.5955261355854827,1558,0.34010499885870804,0.304268431864871,0.3556265692764209
1384,37107,2150,1702,1268,203,448,2150,1.0,0.7916279069767442,0.20837209302325582,679,0.5897674418604651,0.0944186046511628,0.3158139534883721
1385,37107,1998,927,903,554,1071,1998,1.0,0.46396396396396394,0.536036036036036,541,0.4519519519519519,0.2772772772772773,0.2707707707707708
1386,37107,1242,1198,654,9,44,1242,1.0,0.964573268921095,0.03542673107890499,579,0.5265700483091788,0.007246376811594203,0.46618357487922707
1387,37107,2322,1929,1354,168,393,2322,1.0,0.8307493540051679,0.16925064599483206,800,0.5831180017226529,0.07235142118863049,0.34453057708871665
1388,37107,3020,828,796,1199,2192,3020,1.0,0.27417218543046357,0.7258278145695364,1025,0.2635761589403974,0.3970198675496689,0.3394039735099338
1389,37107,1118,1097,857,3,21,1118,1.0,0.981216457960644,0.018783542039355994,258,0.7665474060822898,0.0026833631484794273,0.23076923076923078
1390,37107,1541,872,698,221,669,1541,1.0,0.5658663205710578,0.43413367942894227,622,0.45295262816353016,0.14341336794289422,0.4036340038935756
1391,37107,2709,1190,868,723,1519,2709,1.0,0.4392764857881137,0.5607235142118863,1118,0.32041343669250644,0.26688815060908083,0.4126984126984127
1392,37107,2724,1067,804,825,1657,2724,1.0,0.39170337738619676,0.6082966226138032,1095,0.29515418502202645,0.30286343612334804,0.40198237885462557
1393,37107,1177,66,107,518,1111,1177,1.0,0.056074766355140186,0.9439252336448598,552,0.09090909090909091,0.44010195412064573,0.4689889549702634
1394,37107,1282,69,136,664,1213,1282,1.0,0.05382215288611544,0.9461778471138845,482,0.1060842433697348,0.5179407176287052,0.37597503900156004
1395,37107,1622,925,747,310,697,1622,1.0,0.5702836004932182,0.42971639950678175,565,0.46054254007398276,0.19112207151664612,0.34833538840937117
1396,37107,1467,143,154,662,1324,1467,1.0,0.09747784594410361,0.9025221540558964,651,0.10497614178595774,0.4512610770279482,0.4437627811860941
1397,37107,793,60,66,371,733,793,1.0,0.07566204287515763,0.9243379571248423,356,0.0832282471626734,0.467843631778058,0.4489281210592686
1398,37109,2558,94,441,1171,2464,2558,1.0,0.03674745895230649,0.9632525410476935,946,0.1724003127443315,0.4577795152462862,0.36982017200938233
1399,37109,2237,326,490,787,1911,2237,1.0,0.14573088958426464,0.8542691104157354,960,0.21904336164506036,0.3518104604380867,0.42914617791685294
1400,37109,2484,345,396,473,2139,2484,1.0,0.1388888888888889,0.8611111111111112,1615,0.15942028985507245,0.19041867954911434,0.6501610305958132
1401,37109,2002,85,350,844,1917,2002,1.0,0.042457542457542456,0.9575424575424576,808,0.17482517482517482,0.42157842157842157,0.4035964035964036
1402,37109,1584,26,186,704,1558,1584,1.0,0.016414141414141416,0.9835858585858586,694,0.11742424242424243,0.4444444444444444,0.43813131313131315
1403,37109,1783,105,352,700,1678,1783,1.0,0.05888951205832866,0.9411104879416713,731,0.19742007851934942,0.3925967470555244,0.4099831744251262
1404,37109,1108,12,243,314,1096,1108,1.0,0.010830324909747292,0.9891696750902527,551,0.21931407942238268,0.2833935018050541,0.4972924187725632
1405,37109,2066,299,597,528,1767,2066,1.0,0.1447241045498548,0.8552758954501453,941,0.28896418199419166,0.25556631171345595,0.4554695062923524
1406,37109,2770,53,452,1074,2717,2770,1.0,0.019133574007220218,0.9808664259927797,1244,0.1631768953068592,0.3877256317689531,0.4490974729241877
1407,37109,1755,249,557,443,1506,1755,1.0,0.14188034188034188,0.8581196581196581,755,0.3173789173789174,0.25242165242165243,0.4301994301994302
1408,37109,3020,70,455,1183,2950,3020,1.0,0.023178807947019868,0.9768211920529801,1382,0.15066225165562913,0.39172185430463574,0.45761589403973507
1409,37109,1108,94,271,545,1014,1108,1.0,0.08483754512635379,0.9151624548736462,292,0.24458483754512636,0.4918772563176895,0.26353790613718414
1410,37109,1764,28,277,561,1736,1764,1.0,0.015873015873015872,0.9841269841269841,926,0.15702947845804988,0.31802721088435376,0.5249433106575964
1411,37109,2905,40,479,1191,2865,2905,1.0,0.013769363166953529,0.9862306368330465,1235,0.1648881239242685,0.4099827882960413,0.42512908777969016
1412,37109,3812,101,814,2166,3711,3812,1.0,0.026495278069254984,0.973504721930745,832,0.21353620146904512,0.5682056663168941,0.21825813221406087
1413,37109,1471,25,180,671,1446,1471,1.0,0.01699524133242692,0.9830047586675731,620,0.12236573759347383,0.45615227736233854,0.4214819850441876
1414,37109,2823,112,601,1408,2711,2823,1.0,0.03967410556145944,0.9603258944385406,814,0.2128940843074743,0.4987601842012044,0.2883457314913213
1415,37109,1770,65,270,815,1705,1770,1.0,0.03672316384180791,0.963276836158192,685,0.15254237288135594,0.4604519774011299,0.3870056497175141
1416,37109,1362,180,253,481,1182,1362,1.0,0.13215859030837004,0.8678414096916299,628,0.18575624082232012,0.35315712187958886,0.461086637298091
1417,37109,1402,13,241,901,1389,1402,1.0,0.009272467902995721,0.9907275320970043,260,0.1718972895863053,0.6426533523537803,0.18544935805991442
1418,37109,1764,29,367,1031,1735,1764,1.0,0.016439909297052153,0.9835600907029478,366,0.20804988662131518,0.5844671201814059,0.20748299319727892
1419,37109,2515,272,517,1069,2243,2515,1.0,0.10815109343936381,0.8918489065606362,929,0.20556660039761432,0.42504970178926443,0.36938369781312125
1420,37109,2210,47,289,1175,2163,2210,1.0,0.021266968325791856,0.9787330316742081,746,0.13076923076923078,0.5316742081447964,0.3375565610859729
1421,37109,2644,49,429,1314,2595,2644,1.0,0.018532526475037822,0.9814674735249622,901,0.16225416036308624,0.4969742813918306,0.3407715582450832
1422,37109,2234,131,427,1158,2103,2234,1.0,0.05863921217547001,0.94136078782453,649,0.19113697403760072,0.5183527305282005,0.29051029543419876
1423,37109,2582,47,378,1199,2535,2582,1.0,0.01820294345468629,0.9817970565453137,1005,0.1463981409759876,0.4643687064291247,0.38923315259488767
1424,37109,2156,270,415,566,1886,2156,1.0,0.12523191094619665,0.8747680890538033,1175,0.1924860853432282,0.2625231910946197,0.5449907235621522
1425,37109,1895,60,294,794,1835,1895,1.0,0.0316622691292876,0.9683377308707124,807,0.15514511873350922,0.41899736147757255,0.4258575197889182
1426,37111,859,2,152,361,857,859,1.0,0.002328288707799767,0.9976717112922002,346,0.1769499417927823,0.420256111757858,0.40279394644935973
1427,37111,2638,40,386,829,2598,2638,1.0,0.015163002274450341,0.9848369977255497,1423,0.1463229719484458,0.31425322213798335,0.5394238059135709
1428,37111,1957,6,278,766,1951,1957,1.0,0.0030659172202350538,0.9969340827797649,913,0.14205416453755748,0.39141543178334187,0.46653040367910065
1429,37111,1894,10,280,761,1884,1894,1.0,0.005279831045406547,0.9947201689545935,853,0.14783526927138332,0.40179514255543824,0.45036958817317846
1430,37111,1445,20,181,350,1425,1445,1.0,0.01384083044982699,0.986159169550173,914,0.12525951557093426,0.2422145328719723,0.6325259515570935
1431,37111,2295,22,420,1061,2273,2295,1.0,0.009586056644880174,0.9904139433551198,814,0.1830065359477124,0.46230936819172114,0.35468409586056643
1432,37111,1524,77,319,537,1447,1524,1.0,0.0505249343832021,0.949475065616798,668,0.20931758530183728,0.35236220472440943,0.43832020997375326
1433,37111,3357,93,622,1121,3264,3357,1.0,0.02770330652368186,0.9722966934763181,1614,0.18528448019064642,0.3339291033661007,0.48078641644325293
1434,37111,1655,25,216,327,1630,1655,1.0,0.015105740181268883,0.9848942598187311,1112,0.13051359516616315,0.19758308157099697,0.6719033232628399
1435,37111,2640,348,255,473,2292,2640,1.0,0.1318181818181818,0.8681818181818182,1912,0.09659090909090909,0.17916666666666667,0.7242424242424242
1436,37111,1211,22,204,315,1189,1211,1.0,0.018166804293971925,0.9818331957060281,692,0.16845582163501238,0.26011560693641617,0.5714285714285714
1437,37111,4238,176,716,1317,4062,4238,1.0,0.04152902312411515,0.9584709768758849,2205,0.16894761680037754,0.3107597923548844,0.5202925908447381
1438,37111,1930,17,487,1111,1913,1930,1.0,0.008808290155440414,0.9911917098445596,332,0.2523316062176166,0.5756476683937823,0.17202072538860103
1439,37111,2057,98,267,430,1959,2057,1.0,0.047642197374817695,0.9523578026251823,1360,0.12980068060281963,0.20904229460379192,0.6611570247933884
1440,37111,1826,309,552,417,1517,1826,1.0,0.1692223439211391,0.8307776560788609,857,0.3023001095290252,0.22836801752464403,0.4693318729463308
1441,37111,2727,100,570,1181,2627,2727,1.0,0.03667033370003667,0.9633296662999633,976,0.20902090209020902,0.4330766409974331,0.3579024569123579
1442,37111,958,2,126,418,956,958,1.0,0.0020876826722338203,0.9979123173277662,414,0.1315240083507307,0.4363256784968685,0.4321503131524008
1443,37113,2245,7,447,868,2238,2245,1.0,0.0031180400890868597,0.9968819599109131,930,0.19910913140311803,0.3866369710467706,0.4142538975501114
1444,37113,380,6,95,197,374,380,1.0,0.015789473684210527,0.9842105263157894,88,0.25,0.5184210526315789,0.23157894736842105
1445,37113,3071,21,568,1141,3050,3071,1.0,0.006838163464669489,0.9931618365353305,1362,0.18495604037772712,0.37154021491370887,0.44350374470856396
1446,37113,2296,9,559,1055,2287,2296,1.0,0.0039198606271777,0.9960801393728222,682,0.24346689895470383,0.4594947735191638,0.2970383275261324
1447,37113,2991,13,563,1101,2978,2991,1.0,0.0043463724506853894,0.9956536275493146,1327,0.18823136074891342,0.36810431293881646,0.44366432631227015
1448,37113,451,0,70,217,451,451,1.0,0.0,1.0,164,0.15521064301552107,0.4811529933481153,0.36363636363636365
1449,37113,1495,30,335,492,1465,1495,1.0,0.020066889632107024,0.979933110367893,668,0.22408026755852842,0.3290969899665552,0.4468227424749164
1450,37113,2007,115,549,874,1892,2007,1.0,0.057299451918286,0.942700548081714,584,0.273542600896861,0.4354758345789736,0.2909815645241654
1451,37113,2208,6,403,889,2202,2208,1.0,0.002717391304347826,0.9972826086956522,916,0.182518115942029,0.4026268115942029,0.4148550724637681
1452,37113,667,0,82,289,667,667,1.0,0.0,1.0,296,0.12293853073463268,0.4332833583208396,0.44377811094452774
1453,37113,751,0,151,325,751,751,1.0,0.0,1.0,275,0.2010652463382157,0.43275632490013316,0.36617842876165113
1454,37113,1871,6,406,809,1865,1871,1.0,0.003206841261357563,0.9967931587386424,656,0.2169962586851951,0.4323890967397114,0.35061464457509356
1455,37113,1612,7,307,597,1605,1612,1.0,0.004342431761786601,0.9956575682382134,708,0.19044665012406947,0.37034739454094295,0.4392059553349876
1456,37113,2614,60,587,995,2554,2614,1.0,0.022953328232593728,0.9770466717674062,1032,0.22456006120887528,0.38064269319051264,0.3947972456006121
1457,37113,2729,41,589,950,2688,2729,1.0,0.015023818248442653,0.9849761817515573,1190,0.2158299743495786,0.348112861854159,0.43605716379626236
1458,37115,437,1,136,147,436,437,1.0,0.002288329519450801,0.9977116704805492,154,0.3112128146453089,0.33638443935926776,0.3524027459954233
1459,37115,2466,3,651,749,2463,2466,1.0,0.0012165450121654502,0.9987834549878345,1066,0.2639902676399027,0.3037307380373074,0.43227899432278993
1460,37115,945,1,233,277,944,945,1.0,0.0010582010582010583,0.9989417989417989,435,0.24656084656084656,0.2931216931216931,0.4603174603174603
1461,37115,263,7,105,49,256,263,1.0,0.026615969581749048,0.973384030418251,109,0.39923954372623577,0.18631178707224336,0.4144486692015209
1462,37115,1148,3,253,361,1145,1148,1.0,0.002613240418118467,0.9973867595818815,534,0.22038327526132404,0.3144599303135889,0.4651567944250871
1463,37115,1002,7,215,385,995,1002,1.0,0.006986027944111776,0.9930139720558883,402,0.21457085828343314,0.3842315369261477,0.40119760479041916
1464,37115,3867,177,977,1093,3690,3867,1.0,0.045771916214119475,0.9542280837858805,1797,0.25265063356607187,0.282648047582105,0.46470131885182314
1465,37115,982,3,303,281,979,982,1.0,0.003054989816700611,0.9969450101832994,398,0.3085539714867617,0.2861507128309572,0.40529531568228105
1466,37115,1330,0,310,432,1330,1330,1.0,0.0,1.0,588,0.23308270676691728,0.324812030075188,0.4421052631578947
1467,37115,952,5,261,232,947,952,1.0,0.005252100840336135,0.9947478991596639,459,0.27415966386554624,0.24369747899159663,0.48214285714285715
1468,37115,780,2,241,187,778,780,1.0,0.002564102564102564,0.9974358974358974,352,0.308974358974359,0.23974358974358975,0.4512820512820513
1469,37115,2500,8,576,890,2492,2500,1.0,0.0032,0.9968,1034,0.2304,0.356,0.4136
1470,37117,994,258,221,435,736,994,1.0,0.2595573440643863,0.7404426559356136,338,0.22233400402414488,0.43762575452716296,0.34004024144869216
1471,37117,2075,548,560,820,1527,2075,1.0,0.2640963855421687,0.7359036144578314,695,0.26987951807228916,0.39518072289156625,0.3349397590361446
1472,37117,1004,174,208,536,830,1004,1.0,0.17330677290836655,0.8266932270916335,260,0.20717131474103587,0.5338645418326693,0.2589641434262948
1473,37117,905,537,392,222,368,905,1.0,0.5933701657458563,0.4066298342541437,291,0.4331491712707182,0.24530386740331492,0.32154696132596683
1474,37117,929,525,416,199,404,929,1.0,0.5651237890204521,0.43487621097954793,314,0.4477933261571582,0.21420882669537136,0.3379978471474704
1475,37117,3359,1688,1429,795,1671,3359,1.0,0.5025305150342364,0.4974694849657636,1135,0.42542423340279845,0.23667758261387317,0.3378981839833284
1476,37117,312,188,153,80,124,312,1.0,0.6025641025641025,0.3974358974358974,79,0.49038461538461536,0.2564102564102564,0.2532051282051282
1477,37117,1536,970,679,300,566,1536,1.0,0.6315104166666666,0.3684895833333333,557,0.4420572916666667,0.1953125,0.3626302083333333
1478,37117,3593,1700,1245,918,1893,3593,1.0,0.4731422209852491,0.526857779014751,1430,0.3465070971333148,0.2554967993320345,0.3979961035346507
1479,37117,387,111,109,112,276,387,1.0,0.2868217054263566,0.7131782945736435,166,0.28165374677002586,0.28940568475452194,0.4289405684754522
1480,37117,1196,705,520,253,491,1196,1.0,0.5894648829431438,0.4105351170568562,423,0.43478260869565216,0.21153846153846154,0.3536789297658863
1481,37117,1158,365,318,410,793,1158,1.0,0.31519861830742657,0.6848013816925734,430,0.27461139896373055,0.3540587219343696,0.37132987910189985
1482,37117,1622,216,265,889,1406,1622,1.0,0.13316892725030827,0.8668310727496917,468,0.16337854500616522,0.5480887792848336,0.2885326757090012
1483,37119,2770,1570,1269,165,1200,2770,1.0,0.5667870036101083,0.4332129963898917,1336,0.4581227436823105,0.05956678700361011,0.48231046931407945
1484,37119,3152,657,1041,375,2495,3152,1.0,0.20843908629441624,0.7915609137055838,1736,0.33026649746192893,0.11897208121827411,0.550761421319797
1485,37119,2461,546,1297,343,1915,2461,1.0,0.22186103210077204,0.778138967899228,821,0.5270215359609914,0.13937423811458757,0.33360422592442096
1486,37119,2659,2428,1774,30,231,2659,1.0,0.9131252350507709,0.08687476494922904,855,0.6671681083113953,0.011282437006393382,0.32154945468221136
1487,37119,1690,8,490,1165,1682,1690,1.0,0.004733727810650888,0.9952662721893492,35,0.28994082840236685,0.6893491124260355,0.020710059171597635
1488,37119,3136,822,987,302,2314,3136,1.0,0.26211734693877553,0.7378826530612245,1847,0.31473214285714285,0.09630102040816327,0.5889668367346939
1489,37119,3257,808,1148,456,2449,3257,1.0,0.24808105618667486,0.7519189438133251,1653,0.35247159963156277,0.14000614062020264,0.5075222597482346
1490,37119,2426,262,584,1048,2164,2426,1.0,0.1079967023907667,0.8920032976092334,794,0.2407254740313273,0.4319868095630668,0.32728771640560594
1491,37119,4229,236,910,2134,3993,4229,1.0,0.055805154882951055,0.944194845117049,1185,0.21518089382832822,0.5046110191534642,0.2802080870182076
1492,37119,6351,3347,3222,1023,3004,6351,1.0,0.5270036214769328,0.47299637852306725,2106,0.507321681624941,0.161076995748701,0.33160132262635805
1493,37119,3466,1266,1501,835,2200,3466,1.0,0.36526255049047895,0.634737449509521,1130,0.43306405077899596,0.24091171379111367,0.32602423542989034
1494,37119,6055,2020,2687,1825,4035,6055,1.0,0.33360858794384807,0.6663914120561519,1543,0.44376548307184144,0.3014037985136251,0.2548307184145334
1495,37119,3036,779,980,749,2257,3036,1.0,0.25658761528326746,0.7434123847167325,1307,0.3227931488801054,0.24670619235836627,0.4305006587615283
1496,37119,4171,466,1150,1384,3705,4171,1.0,0.11172380724046992,0.8882761927595301,1637,0.2757132582114601,0.33181491249100936,0.39247182929753055
1497,37119,5336,374,1768,2212,4962,5336,1.0,0.07008995502248876,0.9299100449775113,1356,0.3313343328335832,0.41454272863568215,0.25412293853073464
1498,37119,6274,1222,2249,2126,5052,6274,1.0,0.19477207523111253,0.8052279247688875,1899,0.35846350015938794,0.3388587822760599,0.30267771756455214
1499,37119,6725,1938,2738,1289,4787,6725,1.0,0.28817843866171006,0.71182156133829,2698,0.4071375464684015,0.1916728624535316,0.4011895910780669
1500,37119,4816,745,1563,1221,4071,4816,1.0,0.15469269102990033,0.8453073089700996,2032,0.32454318936877075,0.2535299003322259,0.4219269102990033
1501,37119,5142,340,1586,2098,4802,5142,1.0,0.06612213146635551,0.9338778685336445,1458,0.308440295604823,0.40801244651886426,0.28354725787631274
1502,37119,3921,91,1071,2063,3830,3921,1.0,0.02320836521295588,0.9767916347870441,787,0.27314460596786533,0.5261412904871207,0.20071410354501404
1503,37119,4107,712,1228,1076,3395,4107,1.0,0.17336255174093013,0.8266374482590699,1803,0.2990017044071098,0.26199172145118094,0.4390065741417093
1504,37119,1635,196,629,636,1439,1635,1.0,0.1198776758409786,0.8801223241590214,370,0.38470948012232414,0.3889908256880734,0.22629969418960244
1505,37119,2492,108,899,1065,2384,2492,1.0,0.04333868378812199,0.956661316211878,528,0.36075441412520065,0.42736757624398075,0.21187800963081863
1506,37119,2262,91,717,811,2171,2262,1.0,0.040229885057471264,0.9597701149425287,734,0.3169761273209549,0.35853227232537577,0.3244916003536693
1507,37119,3031,594,867,449,2437,3031,1.0,0.19597492576707357,0.8040250742329265,1715,0.2860442098317387,0.14813592873639064,0.5658198614318707
1508,37119,3121,2589,1489,46,532,3121,1.0,0.8295418135213073,0.17045818647869274,1586,0.47709067606536365,0.014738865748157642,0.5081704581864787
1509,37119,3188,2254,1537,128,934,3188,1.0,0.7070263488080301,0.2929736511919699,1523,0.4821204516938519,0.04015056461731493,0.4777289836888331
1510,37119,3650,2716,1954,53,934,3650,1.0,0.7441095890410959,0.25589041095890414,1643,0.5353424657534247,0.01452054794520548,0.4501369863013699
1511,37119,3863,187,829,1919,3676,3863,1.0,0.04840797307791871,0.9515920269220813,1115,0.21460005177323324,0.496764172922599,0.28863577530416773
1512,37119,4676,1902,2012,552,2774,4676,1.0,0.4067579127459367,0.5932420872540634,2112,0.43028229255774164,0.11804961505560307,0.4516680923866553
1513,37119,2924,713,1298,884,2211,2924,1.0,0.24384404924760603,0.756155950752394,742,0.4439124487004104,0.3023255813953488,0.25376196990424077
1514,37119,3854,1561,1961,630,2293,3854,1.0,0.4050337311883757,0.5949662688116243,1263,0.5088220031136481,0.1634665282823041,0.32771146860404776
1515,37119,3320,1074,1511,655,2246,3320,1.0,0.32349397590361445,0.6765060240963855,1154,0.4551204819277108,0.19728915662650603,0.34759036144578315
1516,37119,9286,2193,3840,2836,7093,9286,1.0,0.23616196424725394,0.7638380357527461,2610,0.41352573766961015,0.3054059875080767,0.28106827482231317
1517,37119,4448,657,1499,1978,3791,4448,1.0,0.1477068345323741,0.8522931654676259,971,0.3370053956834532,0.44469424460431656,0.21830035971223022
1518,37119,2536,80,476,1774,2456,2536,1.0,0.031545741324921134,0.9684542586750788,286,0.18769716088328076,0.6995268138801262,0.11277602523659307
1519,37119,4341,116,1098,2264,4225,4341,1.0,0.026721953466943102,0.9732780465330569,979,0.25293711126468554,0.5215388159410275,0.22552407279428702
1520,37119,8303,2100,3294,2116,6203,8303,1.0,0.25292063109719376,0.7470793689028062,2893,0.39672407563531253,0.2548476454293629,0.3484282789353246
1521,37119,3017,216,680,1434,2801,3017,1.0,0.07159429897248923,0.9284057010275107,903,0.22538945972820681,0.4753065959562479,0.29930394431554525
1522,37119,4182,2141,1890,190,2041,4182,1.0,0.5119560019129603,0.4880439980870397,2102,0.4519368723098996,0.04543280726924916,0.5026303204208513
1523,37119,1732,267,775,383,1465,1732,1.0,0.1541570438799076,0.8458429561200924,574,0.447459584295612,0.22113163972286373,0.33140877598152424
1524,37119,3104,709,829,346,2395,3104,1.0,0.22841494845360824,0.7715850515463918,1929,0.26707474226804123,0.11146907216494846,0.6214561855670103
1525,37119,3584,1213,1384,408,2371,3584,1.0,0.3384486607142857,0.6615513392857143,1792,0.3861607142857143,0.11383928571428571,0.5
1526,37119,2521,167,784,1149,2354,2521,1.0,0.06624355414518049,0.9337564458548195,588,0.3109877032923443,0.4557715192383975,0.23324077746925823
1527,37119,1610,22,460,1095,1588,1610,1.0,0.013664596273291925,0.986335403726708,55,0.2857142857142857,0.6801242236024845,0.034161490683229816
1528,37119,3856,892,1255,1067,2964,3856,1.0,0.23132780082987553,0.7686721991701245,1534,0.3254668049792531,0.2767116182572614,0.39782157676348545
1529,37119,4736,2423,2750,592,2313,4736,1.0,0.5116131756756757,0.48838682432432434,1394,0.5806587837837838,0.125,0.29434121621621623
1530,37119,4608,2104,2510,561,2504,4608,1.0,0.4565972222222222,0.5434027777777778,1537,0.5447048611111112,0.12174479166666667,0.3335503472222222
1531,37119,7110,673,2130,2648,6437,7110,1.0,0.09465541490857947,0.9053445850914206,2332,0.29957805907172996,0.3724331926863572,0.3279887482419128
1532,37119,3278,62,1066,2007,3216,3278,1.0,0.018913971934106162,0.9810860280658938,205,0.32519829164124464,0.6122635753508237,0.06253813300793166
1533,37119,5656,497,2254,1616,5159,5656,1.0,0.08787128712871287,0.9121287128712872,1786,0.39851485148514854,0.2857142857142857,0.31577086280056577
1534,37119,3676,1830,1429,213,1846,3676,1.0,0.49782372143634385,0.5021762785636561,2034,0.38873775843307945,0.05794341675734494,0.5533188248095756
1535,37119,2098,107,739,917,1991,2098,1.0,0.05100095328884652,0.9489990467111534,442,0.35224022878932315,0.43708293612964727,0.21067683508102955
1536,37119,2465,322,769,523,2143,2465,1.0,0.1306288032454361,0.8693711967545639,1173,0.31196754563894524,0.21217038539553754,0.47586206896551725
1537,37119,3058,300,1077,918,2758,3058,1.0,0.09810333551340746,0.9018966644865926,1063,0.35219097449313275,0.3001962066710268,0.34761281883584044
1538,37119,2649,2321,1926,53,328,2649,1.0,0.8761796904492262,0.12382030955077387,670,0.7270668176670442,0.020007550018875046,0.2529256323140808
1539,37119,2462,2280,1853,25,182,2462,1.0,0.9260763606823721,0.07392363931762795,584,0.7526401299756296,0.010154346060113728,0.2372055239642567
1540,37119,1741,1561,1173,5,180,1741,1.0,0.8966111430212521,0.10338885697874785,563,0.6737507179781734,0.002871912693854107,0.32337736932797245
1541,37119,1752,1533,1075,18,219,1752,1.0,0.875,0.125,659,0.6135844748858448,0.010273972602739725,0.3761415525114155
1542,37119,2775,202,672,958,2573,2775,1.0,0.0727927927927928,0.9272072072072072,1145,0.24216216216216216,0.34522522522522525,0.4126126126126126
1543,37119,1760,202,623,516,1558,1760,1.0,0.11477272727272728,0.8852272727272728,621,0.35397727272727275,0.29318181818181815,0.3528409090909091
1544,37119,1739,177,570,382,1562,1739,1.0,0.10178263369752731,0.8982173663024727,787,0.32777458309373203,0.21966647498562392,0.45255894192064405
1545,37119,2186,1793,1497,61,393,2186,1.0,0.8202195791399817,0.1797804208600183,628,0.6848124428179323,0.027904849039341262,0.28728270814272644
1546,37119,3339,1049,1244,516,2290,3339,1.0,0.3141659179395028,0.6858340820604971,1579,0.3725666367175801,0.1545372866127583,0.4728960766696616
1547,37119,3476,1352,1186,247,2124,3476,1.0,0.38895281933256615,0.6110471806674338,2043,0.3411967779056387,0.07105868814729574,0.5877445339470656
1548,37119,2887,1076,1183,243,1811,2887,1.0,0.3727052303429165,0.6272947696570835,1461,0.4097679251818497,0.08417041912019398,0.5060616556979564
1549,37119,1446,368,608,261,1078,1446,1.0,0.2544951590594744,0.7455048409405256,577,0.42047026279391425,0.18049792531120332,0.39903181189488246
1550,37119,1379,102,511,592,1277,1379,1.0,0.07396664249456128,0.9260333575054387,276,0.37055837563451777,0.42929659173313994,0.2001450326323423
1551,37119,1513,122,605,568,1391,1513,1.0,0.0806345009914078,0.9193654990085922,340,0.3998678122934567,0.3754130865829478,0.2247191011235955
1552,37119,1451,42,489,719,1409,1451,1.0,0.028945554789800137,0.9710544452101999,243,0.3370089593383873,0.49552033080634045,0.16747070985527224
1553,37119,2251,770,829,443,1481,2251,1.0,0.34207019102621056,0.6579298089737894,979,0.3682807641048423,0.19680142159040426,0.43491781430475346
1554,37119,3768,154,1218,1924,3614,3768,1.0,0.04087048832271762,0.9591295116772823,626,0.3232484076433121,0.5106157112526539,0.16613588110403396
1555,37119,1899,23,631,1137,1876,1899,1.0,0.012111637704054766,0.9878883622959452,131,0.33228014744602424,0.5987361769352291,0.06898367561874671
1556,37119,2135,198,576,1043,1937,2135,1.0,0.09274004683840749,0.9072599531615925,516,0.26978922716627635,0.4885245901639344,0.24168618266978922
1557,37119,1517,54,487,708,1463,1517,1.0,0.035596572181938034,0.964403427818062,322,0.3210283454185893,0.46671061305207645,0.2122610415293342
1558,37119,1820,130,634,732,1690,1820,1.0,0.07142857142857142,0.9285714285714286,454,0.34835164835164834,0.4021978021978022,0.24945054945054945
1559,37119,2623,118,669,1168,2505,2623,1.0,0.04498665650019062,0.9550133434998094,786,0.25505146778497906,0.44529165078154787,0.29965688143347313
1560,37119,3102,114,856,1617,2988,3102,1.0,0.0367504835589942,0.9632495164410058,629,0.2759509993552547,0.5212765957446809,0.20277240490006448
1561,37119,2880,99,971,1295,2781,2880,1.0,0.034375,0.965625,614,0.3371527777777778,0.4496527777777778,0.21319444444444444
1562,37119,6015,1544,2174,1350,4471,6015,1.0,0.256691604322527,0.743308395677473,2491,0.36142975893599333,0.22443890274314215,0.4141313383208645
1563,37119,3267,1913,1675,75,1354,3267,1.0,0.5855524946434038,0.41444750535659625,1517,0.5127027854300582,0.02295684113865932,0.46434037343128254
1564,37119,1851,220,509,589,1631,1851,1.0,0.11885467314964884,0.8811453268503512,753,0.2749864937871421,0.31820637493246895,0.406807131280389
1565,37119,4772,1446,1731,723,3326,4772,1.0,0.3030176026823135,0.6969823973176865,2318,0.36274098910310143,0.15150880134115674,0.48575020955574183
1566,37119,5078,2234,2046,402,2844,5078,1.0,0.4399369830641985,0.5600630169358015,2630,0.4029145332808192,0.07916502560063017,0.5179204411185506
1567,37119,2679,864,928,257,1815,2679,1.0,0.322508398656215,0.6774916013437849,1494,0.3463979096677865,0.09593131765584173,0.5576707726763718
1568,37119,2211,699,799,428,1512,2211,1.0,0.31614654002713705,0.683853459972863,984,0.3613749434644957,0.19357756671189508,0.4450474898236092
1569,37119,3418,1474,1550,499,1944,3418,1.0,0.4312463428905793,0.5687536571094207,1369,0.4534815681685196,0.1459918080748976,0.4005266237565828
1570,37119,4818,2765,2388,454,2053,4818,1.0,0.5738895807388958,0.4261104192611042,1976,0.49564134495641343,0.0942299709422997,0.41012868410128683
1571,37119,5096,2692,2096,68,2404,5096,1.0,0.5282574568288854,0.4717425431711146,2932,0.41130298273155413,0.013343799058084773,0.5753532182103611
1572,37119,3827,1211,1533,702,2616,3827,1.0,0.31643585053566764,0.6835641494643324,1592,0.4005748628168278,0.18343349882414423,0.41599163835902797
1573,37119,3722,1538,1387,244,2184,3722,1.0,0.41321869962385815,0.5867813003761418,2091,0.37264911337990325,0.06555615260612574,0.561794734013971
1574,37119,3888,1846,1430,138,2042,3888,1.0,0.4747942386831276,0.5252057613168725,2320,0.367798353909465,0.035493827160493825,0.5967078189300411
1575,37119,2576,454,1041,756,2122,2576,1.0,0.17624223602484473,0.8237577639751553,779,0.4041149068322981,0.29347826086956524,0.30240683229813664
1576,37119,1858,91,540,839,1767,1858,1.0,0.04897739504843918,0.9510226049515608,479,0.2906350914962325,0.45156081808396126,0.25780409041980623
1577,37119,1783,25,459,1221,1758,1783,1.0,0.014021312394840156,0.9859786876051598,103,0.2574312955692653,0.6848008973639933,0.05776780706674145
1578,37119,3492,295,966,921,3197,3492,1.0,0.08447880870561283,0.9155211912943871,1605,0.2766323024054983,0.26374570446735396,0.45962199312714774
1579,37119,6329,2531,2696,1400,3798,6329,1.0,0.3999051982935693,0.6000948017064307,2233,0.4259756675620161,0.2212039816716701,0.3528203507663138
1580,37119,1646,78,567,692,1568,1646,1.0,0.04738760631834751,0.9526123936816525,387,0.3444714459295261,0.4204131227217497,0.23511543134872417
1581,37119,3989,194,1267,2141,3795,3989,1.0,0.04863374279267987,0.9513662572073202,581,0.3176234645274505,0.5367259964903485,0.14565053898220107
1582,37119,3175,287,926,1348,2888,3175,1.0,0.09039370078740157,0.9096062992125984,901,0.2916535433070866,0.4245669291338583,0.2837795275590551
1583,37119,2535,916,1034,398,1619,2535,1.0,0.3613412228796844,0.6386587771203156,1103,0.4078895463510848,0.15700197238658778,0.43510848126232743
1584,37119,2483,1198,1101,247,1285,2483,1.0,0.4824808699154249,0.5175191300845751,1135,0.44341522351993556,0.09947643979057591,0.4571083366894885
1585,37119,1961,128,696,741,1833,1961,1.0,0.06527281998980113,0.9347271800101988,524,0.3549209586945436,0.3778684344722081,0.2672106068332483
1586,37119,3228,468,908,913,2760,3228,1.0,0.1449814126394052,0.8550185873605948,1407,0.2812887236679058,0.28283767038413876,0.4358736059479554
1587,37119,1879,864,876,215,1015,1879,1.0,0.45981905268759976,0.5401809473124002,788,0.466205428419372,0.11442256519425226,0.41937200638637573
1588,37119,5488,1809,1674,167,3679,5488,1.0,0.32962827988338195,0.670371720116618,3647,0.30502915451895046,0.03043002915451895,0.6645408163265306
1589,37119,3696,1558,1247,145,2138,3696,1.0,0.42153679653679654,0.5784632034632035,2304,0.3373917748917749,0.03923160173160173,0.6233766233766234
1590,37119,2871,200,925,1082,2671,2871,1.0,0.06966213862765587,0.9303378613723441,864,0.3221873911529084,0.37687216997561823,0.30094043887147337
1591,37119,3074,269,729,1058,2805,3074,1.0,0.08750813272608979,0.9124918672739102,1287,0.23715029277813923,0.3441769681197137,0.41867273910214703
1592,37119,5457,1725,2162,820,3732,5457,1.0,0.3161077515118197,0.6838922484881803,2475,0.396188381894814,0.15026571376214037,0.45354590434304565
1593,37119,3045,90,1025,1526,2955,3045,1.0,0.029556650246305417,0.9704433497536946,494,0.3366174055829228,0.5011494252873563,0.16223316912972086
1594,37119,3646,2468,2082,153,1178,3646,1.0,0.6769061985737795,0.3230938014262205,1411,0.5710367526055952,0.04196379594075699,0.38699945145364784
1595,37119,5049,1868,1955,435,3181,5049,1.0,0.3699742523271935,0.6300257476728065,2659,0.3872053872053872,0.08615567439096851,0.5266389384036443
1596,37119,1658,89,628,772,1569,1658,1.0,0.05367913148371532,0.9463208685162847,258,0.37876960193003617,0.46562123039806996,0.15560916767189384
1597,37119,5948,2481,2511,452,3467,5948,1.0,0.4171149966375252,0.5828850033624747,2985,0.4221587088096839,0.07599193006052454,0.5018493611297915
1598,37119,3697,1808,1993,476,1889,3697,1.0,0.4890451717608872,0.5109548282391128,1228,0.5390857451988098,0.1287530430078442,0.33216121179334596
1599,37119,1557,74,498,706,1483,1557,1.0,0.047527296082209375,0.9524727039177906,353,0.3198458574181118,0.45343609505459215,0.22671804752729607
1600,37119,2646,448,1250,625,2198,2646,1.0,0.1693121693121693,0.8306878306878307,771,0.47241118669690096,0.23620559334845048,0.29138321995464855
1601,37119,3310,1902,1549,120,1408,3310,1.0,0.5746223564954682,0.4253776435045317,1641,0.46797583081571,0.03625377643504532,0.4957703927492447
1602,37119,2793,1190,1219,389,1603,2793,1.0,0.42606516290726815,0.5739348370927319,1185,0.4364482635159327,0.13927676333691372,0.4242749731471536
1603,37119,2743,994,832,177,1749,2743,1.0,0.36237695953335763,0.6376230404666423,1734,0.3033175355450237,0.06452788917243893,0.6321545752825374
1604,37119,2177,552,806,396,1625,2177,1.0,0.2535599448782728,0.7464400551217272,975,0.3702342673403767,0.18190169958658706,0.4478640330730363
1605,37119,2146,88,1081,576,2058,2146,1.0,0.04100652376514446,0.9589934762348555,489,0.5037278657968313,0.2684063373718546,0.22786579683131408
1606,37119,1319,68,410,628,1251,1319,1.0,0.05155420773313116,0.9484457922668689,281,0.310841546626232,0.4761182714177407,0.21304018195602728
1607,37119,2600,110,865,1155,2490,2600,1.0,0.04230769230769231,0.9576923076923077,580,0.3326923076923077,0.4442307692307692,0.2230769230769231
1608,37119,2099,80,586,1121,2019,2099,1.0,0.038113387327298714,0.9618866126727013,392,0.27918056217246306,0.5340638399237733,0.1867555979037637
1609,37119,3169,168,945,1726,3001,3169,1.0,0.05301356894919533,0.9469864310508047,498,0.2982013253392237,0.5446513095613759,0.15714736509940044
1610,37119,2862,128,879,1417,2734,2862,1.0,0.04472396925227114,0.9552760307477288,566,0.30712788259958074,0.49510831586303283,0.19776380153738643
1611,37119,1947,655,825,375,1292,1947,1.0,0.3364149974319466,0.6635850025680534,747,0.423728813559322,0.1926040061633282,0.38366718027734975
1612,37119,1931,946,1006,196,985,1931,1.0,0.48990160538581046,0.5100983946141895,729,0.520973588814086,0.10150181253236665,0.37752459865354737
1613,37119,2744,1220,1166,356,1524,2744,1.0,0.4446064139941691,0.5553935860058309,1222,0.4249271137026239,0.12973760932944606,0.44533527696793
1614,37119,3255,301,974,1190,2954,3255,1.0,0.09247311827956989,0.9075268817204301,1091,0.29923195084485404,0.3655913978494624,0.3351766513056836
1615,37119,1651,122,547,691,1529,1651,1.0,0.07389460932768019,0.9261053906723198,413,0.33131435493640216,0.418534221683828,0.2501514233797698
1616,37119,2468,118,674,1166,2350,2468,1.0,0.04781199351701783,0.9521880064829822,628,0.273095623987034,0.47244732576985415,0.2544570502431118
1617,37119,2868,522,1175,923,2346,2868,1.0,0.18200836820083682,0.8179916317991632,770,0.4096931659693166,0.3218270571827057,0.2684797768479777
1618,37119,2193,57,1007,854,2136,2193,1.0,0.025991792065663474,0.9740082079343365,332,0.45918832649338803,0.38942088463292296,0.151390788873689
1619,37119,7647,1976,2651,1593,5671,7647,1.0,0.25840198770759776,0.7415980122924023,3403,0.3466718974761344,0.20831698705374657,0.445011115470119
1620,37119,2930,2440,1700,94,490,2930,1.0,0.8327645051194539,0.16723549488054607,1136,0.5802047781569966,0.032081911262798635,0.38771331058020475
1621,37119,4682,1738,1466,199,2944,4682,1.0,0.3712088850918411,0.6287911149081589,3017,0.3131140538231525,0.04250320375907732,0.6443827424177702
1622,37119,3539,162,991,2039,3377,3539,1.0,0.04577564283695959,0.9542243571630404,509,0.280022605255722,0.5761514552133371,0.14382593953094094
1623,37119,2449,1221,1391,332,1228,2449,1.0,0.4985708452429563,0.5014291547570436,726,0.5679869334422213,0.13556553695385873,0.29644752960391996
1624,37119,2959,1822,1611,199,1137,2959,1.0,0.615748563703954,0.38425143629604597,1149,0.5444406894221021,0.06725245015207841,0.3883068604258195
1625,37119,1612,638,712,214,974,1612,1.0,0.3957816377171216,0.6042183622828784,686,0.44168734491315137,0.1327543424317618,0.42555831265508687
1626,37119,3531,1962,1784,328,1569,3531,1.0,0.5556499575191164,0.4443500424808836,1419,0.5052393089776267,0.0928915321438686,0.40186915887850466
1627,37119,3191,844,1336,884,2347,3191,1.0,0.26449388906298965,0.7355061109370103,971,0.41867753055468504,0.27702914446881854,0.3042933249764964
1628,37119,2212,469,558,237,1743,2212,1.0,0.2120253164556962,0.7879746835443038,1417,0.2522603978300181,0.10714285714285714,0.6405967450271248
1629,37119,3366,401,1059,859,2965,3366,1.0,0.11913250148544266,0.8808674985145574,1448,0.3146167557932264,0.2551990493166964,0.43018419489007725
1630,37119,5749,2944,1663,487,2805,5749,1.0,0.5120890589667768,0.4879109410332232,3599,0.28926769873021396,0.08471038441468082,0.6260219168551052
1631,37119,2360,1754,1547,112,606,2360,1.0,0.7432203389830508,0.25677966101694916,701,0.6555084745762711,0.04745762711864407,0.29703389830508475
1632,37119,2548,206,1381,518,2342,2548,1.0,0.08084772370486656,0.9191522762951334,649,0.5419937205651492,0.2032967032967033,0.25470957613814754
1633,37119,2965,2779,2267,27,186,2965,1.0,0.9372681281618886,0.0627318718381113,671,0.7645868465430017,0.009106239460370995,0.2263069139966273
1634,37119,2236,1470,1276,96,766,2236,1.0,0.6574239713774598,0.3425760286225403,864,0.5706618962432916,0.04293381037567084,0.38640429338103754
1635,37119,2091,701,850,316,1390,2091,1.0,0.335246293639407,0.664753706360593,925,0.4065040650406504,0.15112386417981827,0.44237207077953133
1636,37119,1658,50,481,892,1608,1658,1.0,0.030156815440289506,0.9698431845597105,285,0.29010856453558503,0.5379975874547648,0.17189384800965019
1637,37119,2800,768,877,344,2032,2800,1.0,0.2742857142857143,0.7257142857142858,1579,0.3132142857142857,0.12285714285714286,0.5639285714285714
1638,37119,4031,234,1184,2127,3797,4031,1.0,0.058050111634830065,0.9419498883651699,720,0.29372364177623417,0.5276606301165964,0.17861572810716944
1639,37119,6613,630,2012,2232,5983,6613,1.0,0.0952668985331922,0.9047331014668079,2369,0.3042492061091789,0.3375170119461666,0.3582337819446545
1640,37119,8085,4108,3768,636,3977,8085,1.0,0.5081014223871366,0.4918985776128633,3681,0.4660482374768089,0.07866419294990723,0.45528756957328387
1641,37119,2127,81,616,1019,2046,2127,1.0,0.0380818053596615,0.9619181946403385,492,0.28960977903149976,0.4790785143394452,0.231311706629055
1642,37119,5110,288,1394,2713,4822,5110,1.0,0.0563600782778865,0.9436399217221135,1003,0.27279843444227003,0.5309197651663405,0.19628180039138943
1643,37119,3737,1558,1421,383,2179,3737,1.0,0.4169119614664169,0.583088038533583,1933,0.38025153866738026,0.10248862724110248,0.5172598340915172
1644,37119,8593,858,3018,3457,7735,8593,1.0,0.09984871406959153,0.9001512859304085,2118,0.3512161061328989,0.4023042010939136,0.2464796927731875
1645,37119,1411,3,406,998,1408,1411,1.0,0.002126151665485471,0.9978738483345145,7,0.2877391920623671,0.7072997873848335,0.004961020552799433
1646,37119,1771,36,550,819,1735,1771,1.0,0.020327498588368152,0.9796725014116319,402,0.3105590062111801,0.4624505928853755,0.22699040090344438
1647,37119,2093,47,901,877,2046,2093,1.0,0.022455805064500716,0.9775441949354993,315,0.43048256091734355,0.4190157668418538,0.1505016722408027
1648,37119,2386,324,909,543,2062,2386,1.0,0.1357921207041073,0.8642078792958927,934,0.3809723386420788,0.2275775356244761,0.3914501257334451
1649,37119,4043,2086,2273,794,1957,4043,1.0,0.5159534998763294,0.48404650012367056,976,0.5622062824635172,0.19638882018303241,0.24140489735345041
1650,37119,1799,1365,1059,76,434,1799,1.0,0.7587548638132295,0.24124513618677043,664,0.5886603668704836,0.042245692051139525,0.3690939410783769
1651,37119,4119,2606,2108,170,1513,4119,1.0,0.6326778344258315,0.36732216557416847,1841,0.5117747025977178,0.04127215343529983,0.44695314396698227
1652,37119,3509,238,1042,1527,3271,3509,1.0,0.06782559133656313,0.9321744086634369,940,0.2969506982046167,0.4351667141635794,0.26788258763180395
1653,37119,6005,588,1595,2298,5417,6005,1.0,0.09791840133222315,0.9020815986677768,2112,0.2656119900083264,0.3826810990840966,0.351706910907577
1654,37119,3502,232,1037,1552,3270,3502,1.0,0.06624785836664764,0.9337521416333524,913,0.2961165048543689,0.4431753283837807,0.2607081667618504
1655,37119,6627,1362,1979,586,5265,6627,1.0,0.20552286102308737,0.7944771389769126,4062,0.2986268296363362,0.08842613550626226,0.6129470348574015
1656,37119,5239,390,1438,2170,4849,5239,1.0,0.07444168734491315,0.9255583126550868,1631,0.2744798625691926,0.41420118343195267,0.31131895399885473
1657,37119,5309,357,1503,2519,4952,5309,1.0,0.06724430212846111,0.9327556978715389,1287,0.2831041627425127,0.47447730269353927,0.24241853456394802
1658,37119,5621,220,1295,2356,5401,5621,1.0,0.03913894324853229,0.9608610567514677,1970,0.23038605230386053,0.41914250133428216,0.35047144636185734
1659,37119,2304,361,567,549,1943,2304,1.0,0.1566840277777778,0.8433159722222222,1188,0.24609375,0.23828125,0.515625
1660,37119,6280,2172,2779,1450,4108,6280,1.0,0.34585987261146495,0.654140127388535,2051,0.44251592356687897,0.23089171974522293,0.3265923566878981
1661,37119,5537,2550,2747,886,2987,5537,1.0,0.46053819757991693,0.5394618024200831,1904,0.49611703088314973,0.16001444825717898,0.3438685208596713
1662,37119,3236,1020,1367,836,2216,3236,1.0,0.315203955500618,0.6847960444993819,1033,0.42243510506798515,0.2583436341161928,0.319221260815822
1663,37119,5123,407,1279,2131,4716,5123,1.0,0.07944563732188172,0.9205543626781183,1713,0.2496584032793285,0.4159672067148155,0.33437439000585595
1664,37119,4440,545,1409,1873,3895,4440,1.0,0.12274774774774774,0.8772522522522522,1158,0.3173423423423423,0.42184684684684687,0.2608108108108108
1665,37119,6046,4362,3972,384,1684,6046,1.0,0.7214687396625868,0.27853126033741316,1690,0.6569632815084353,0.06351306649024148,0.2795236520013232
1666,37119,7736,2969,3773,1436,4767,7736,1.0,0.38379007238883145,0.6162099276111686,2527,0.48771975180972077,0.18562564632885212,0.3266546018614271
1667,37119,12127,4351,4879,1426,7776,12127,1.0,0.35878617959924136,0.6412138204007586,5822,0.40232538962645337,0.11758885132349303,0.4800857590500536
1668,37119,2602,1863,1683,242,739,2602,1.0,0.7159877017678709,0.28401229823212915,677,0.6468101460415066,0.0930053804765565,0.26018447348193696
1669,37119,3045,1979,1683,160,1066,3045,1.0,0.6499178981937602,0.3500821018062397,1202,0.5527093596059113,0.052545155993431854,0.3947454844006568
1670,37119,2241,2132,1756,11,109,2241,1.0,0.9513609995537706,0.04863900044622936,474,0.783578759482374,0.0049085229808121375,0.21151271753681392
1671,37119,3693,2582,2290,258,1111,3693,1.0,0.6991605740590306,0.3008394259409694,1145,0.620092066070945,0.06986190089358245,0.3100460330354725
1672,37119,3721,2513,1717,80,1208,3721,1.0,0.6753560870733674,0.32464391292663264,1924,0.4614350980919108,0.021499596882558453,0.5170653050255307
1673,37119,4867,2980,2646,321,1887,4867,1.0,0.6122868296692008,0.3877131703307993,1900,0.5436613930552702,0.06595438668584344,0.39038422025888636
1674,37119,3255,1236,1681,719,2019,3255,1.0,0.3797235023041475,0.6202764976958526,855,0.5164362519201229,0.22089093701996929,0.2626728110599078
1675,37119,3572,371,1058,1391,3201,3572,1.0,0.10386338185890258,0.8961366181410975,1123,0.2961926091825308,0.38941769316909297,0.31438969764837627
1676,37119,4813,668,1484,1700,4145,4813,1.0,0.1387907749844172,0.8612092250155828,1629,0.3083316019114897,0.3532100560980677,0.33845834199044256
1677,37119,2763,175,685,1333,2588,2763,1.0,0.06333695258776692,0.936663047412233,745,0.24791892870068766,0.4824466159971046,0.26963445530220775
1678,37121,1472,9,234,684,1463,1472,1.0,0.006114130434782609,0.9938858695652174,554,0.15896739130434784,0.46467391304347827,0.3763586956521739
1679,37121,6555,23,991,2890,6532,6555,1.0,0.0035087719298245615,0.9964912280701754,2674,0.15118230358504958,0.440884820747521,0.4079328756674294
1680,37121,648,3,59,334,645,648,1.0,0.004629629629629629,0.9953703703703703,255,0.09104938271604938,0.5154320987654321,0.39351851851851855
1681,37121,202,0,23,132,202,202,1.0,0.0,1.0,47,0.11386138613861387,0.6534653465346535,0.23267326732673269
1682,37121,971,1,95,448,970,971,1.0,0.0010298661174047373,0.9989701338825953,428,0.09783728115345006,0.46138002059732236,0.4407826982492276
1683,37121,630,1,85,309,629,630,1.0,0.0015873015873015873,0.9984126984126984,236,0.1349206349206349,0.49047619047619045,0.3746031746031746
1684,37121,1440,1,281,622,1439,1440,1.0,0.0006944444444444445,0.9993055555555556,537,0.1951388888888889,0.43194444444444446,0.3729166666666667
1685,37121,295,0,36,179,295,295,1.0,0.0,1.0,80,0.12203389830508475,0.6067796610169491,0.2711864406779661
1686,37121,331,0,23,189,331,331,1.0,0.0,1.0,119,0.06948640483383686,0.5709969788519638,0.3595166163141994
1687,37123,1602,15,212,667,1587,1602,1.0,0.009363295880149813,0.9906367041198502,723,0.132334581772784,0.416354556803995,0.45131086142322097
1688,37123,371,0,38,185,371,371,1.0,0.0,1.0,148,0.10242587601078167,0.49865229110512127,0.39892183288409705
1689,37123,1500,18,225,673,1482,1500,1.0,0.012,0.988,602,0.15,0.44866666666666666,0.4013333333333333
1690,37123,564,189,212,133,375,564,1.0,0.3351063829787234,0.6648936170212766,219,0.375886524822695,0.23581560283687944,0.3882978723404255
1691,37123,640,13,78,290,627,640,1.0,0.0203125,0.9796875,272,0.121875,0.453125,0.425
1692,37123,2457,550,367,626,1907,2457,1.0,0.22385022385022385,0.7761497761497762,1464,0.14936914936914936,0.2547822547822548,0.5958485958485958
1693,37123,1771,952,982,392,819,1771,1.0,0.5375494071146245,0.4624505928853755,397,0.554488989271598,0.22134387351778656,0.22416713721061546
1694,37123,2189,105,254,769,2084,2189,1.0,0.047967108268615805,0.9520328917313842,1166,0.11603471904979443,0.351301964367291,0.5326633165829145
1695,37123,2048,364,473,484,1684,2048,1.0,0.177734375,0.822265625,1091,0.23095703125,0.236328125,0.53271484375
1696,37123,1174,102,196,444,1072,1174,1.0,0.0868824531516184,0.9131175468483816,534,0.16695059625212946,0.3781942078364566,0.454855195911414
1697,37123,2481,568,638,766,1913,2481,1.0,0.22893994357114067,0.7710600564288593,1077,0.2571543732365981,0.30874647319629184,0.43409915356711004
1698,37123,761,100,142,350,661,761,1.0,0.1314060446780552,0.8685939553219448,269,0.18659658344283836,0.45992115637319314,0.35348226018396844
1699,37123,2252,369,499,495,1883,2252,1.0,0.163854351687389,0.8361456483126111,1258,0.22158081705150978,0.21980461811722912,0.5586145648312612
1700,37123,1242,543,390,130,699,1242,1.0,0.43719806763285024,0.5628019323671497,722,0.3140096618357488,0.10466988727858294,0.5813204508856683
1701,37125,3710,226,935,1960,3484,3710,1.0,0.06091644204851752,0.9390835579514825,815,0.25202156334231807,0.5283018867924528,0.2196765498652291
1702,37125,2065,155,234,587,1910,2065,1.0,0.07506053268765134,0.9249394673123487,1244,0.11331719128329298,0.28426150121065374,0.6024213075060533
1703,37125,2068,197,289,934,1871,2068,1.0,0.09526112185686654,0.9047388781431335,845,0.13974854932301742,0.45164410058027077,0.4086073500967118
1704,37125,2854,282,557,1149,2572,2854,1.0,0.09880868955851436,0.9011913104414856,1148,0.1951646811492642,0.4025928521373511,0.4022424667133847
1705,37125,2330,123,297,1175,2207,2330,1.0,0.05278969957081545,0.9472103004291845,858,0.1274678111587983,0.5042918454935622,0.3682403433476395
1706,37125,5442,844,1222,2078,4598,5442,1.0,0.15509004042631386,0.8449099595736862,2142,0.2245497978684307,0.3818449099595737,0.3936052921719956
1707,37125,4641,203,973,2583,4438,4641,1.0,0.043740573152337855,0.9562594268476622,1085,0.2096530920060332,0.5565610859728507,0.23378582202111614
1708,37125,2637,633,779,822,2004,2637,1.0,0.24004550625711035,0.7599544937428896,1036,0.29541145240803945,0.3117178612059158,0.3928706863860447
1709,37125,2321,251,463,767,2070,2321,1.0,0.10814304179233089,0.8918569582076691,1091,0.1994829814735028,0.33046100818612667,0.47005601034037053
1710,37125,4133,811,1076,1290,3322,4133,1.0,0.19622550205661746,0.8037744979433825,1767,0.2603435760948464,0.31212194531817083,0.42753447858698285
1711,37125,3272,1636,1550,759,1636,3272,1.0,0.5,0.5,963,0.4737163814180929,0.2319682151589242,0.2943154034229829
1712,37125,2363,378,624,923,1985,2363,1.0,0.1599661447312738,0.8400338552687262,816,0.264071096064325,0.39060516292848074,0.34532374100719426
1713,37125,3944,105,894,2213,3839,3944,1.0,0.026622718052738338,0.9733772819472617,837,0.22667342799188642,0.561105476673428,0.2122210953346856
1714,37125,2887,325,530,1039,2562,2887,1.0,0.11257360581918947,0.8874263941808105,1318,0.1835815725666782,0.3598891582958088,0.456529269137513
1715,37125,2530,576,723,813,1954,2530,1.0,0.2276679841897233,0.7723320158102767,994,0.2857707509881423,0.32134387351778654,0.39288537549407115
1716,37125,2477,428,490,985,2049,2477,1.0,0.1727896649172386,0.8272103350827614,1002,0.19781994348001614,0.3976584578118692,0.40452159870811466
1717,37125,2268,51,378,1282,2217,2268,1.0,0.022486772486772486,0.9775132275132276,608,0.16666666666666666,0.5652557319223986,0.26807760141093473
1718,37125,2649,253,733,892,2396,2649,1.0,0.09550773876934693,0.9044922612306531,1024,0.27670819177047945,0.33673084182710455,0.386560966402416
1719,37125,630,385,355,104,245,630,1.0,0.6111111111111112,0.3888888888888889,171,0.5634920634920635,0.16507936507936508,0.2714285714285714
1720,37125,2574,114,702,1420,2460,2574,1.0,0.04428904428904429,0.9557109557109557,452,0.2727272727272727,0.5516705516705517,0.17560217560217561
1721,37125,3212,65,661,1927,3147,3212,1.0,0.020236612702366128,0.9797633872976339,624,0.20579078455790784,0.5999377334993773,0.19427148194271482
1722,37125,3217,198,899,1535,3019,3217,1.0,0.06154802611128381,0.9384519738887162,783,0.2794529064345664,0.4771526266708113,0.24339446689462232
1723,37125,3260,142,755,1600,3118,3260,1.0,0.043558282208588955,0.9564417177914111,905,0.23159509202453987,0.49079754601226994,0.2776073619631902
1724,37125,1614,275,386,658,1339,1614,1.0,0.17038413878562578,0.8296158612143743,570,0.23915737298636927,0.4076827757125155,0.35315985130111527
1725,37127,2219,1251,1078,420,968,2219,1.0,0.5637674628210906,0.4362325371789094,721,0.48580441640378547,0.1892744479495268,0.3249211356466877
1726,37127,1061,534,443,296,527,1061,1.0,0.5032987747408105,0.49670122525918947,322,0.4175306314797361,0.27898209236569277,0.30348727615457116
1727,37127,1299,284,352,668,1015,1299,1.0,0.21862971516551194,0.7813702848344881,279,0.270977675134719,0.5142417244033872,0.21478060046189376
1728,37127,844,541,526,157,303,844,1.0,0.6409952606635071,0.3590047393364929,161,0.6232227488151659,0.18601895734597157,0.19075829383886256
1729,37127,2684,680,600,786,2004,2684,1.0,0.2533532041728763,0.7466467958271237,1298,0.22354694485842028,0.29284649776453053,0.48360655737704916
1730,37127,2447,558,649,1251,1889,2447,1.0,0.22803432774826318,0.7719656722517368,547,0.26522272170004085,0.5112382509194933,0.22353902738046588
1731,37127,2910,267,440,1846,2643,2910,1.0,0.09175257731958762,0.9082474226804124,624,0.15120274914089346,0.6343642611683848,0.21443298969072164
1732,37127,2922,916,1038,1095,2006,2922,1.0,0.3134839151266256,0.6865160848733745,789,0.35523613963039014,0.37474332648870634,0.27002053388090347
1733,37127,1540,485,503,493,1055,1540,1.0,0.31493506493506496,0.685064935064935,544,0.32662337662337665,0.32012987012987015,0.35324675324675325
1734,37127,3234,1494,1381,669,1740,3234,1.0,0.4619666048237477,0.5380333951762524,1184,0.4270253555967842,0.20686456400742115,0.3661100803957947
1735,37127,8013,3012,2464,2647,5001,8013,1.0,0.37588918008236616,0.6241108199176338,2902,0.30750031199301137,0.3303382004243105,0.36216148758267813
1736,37127,3416,738,838,1584,2678,3416,1.0,0.21604215456674472,0.7839578454332553,994,0.24531615925058547,0.4637002341920375,0.29098360655737704
1737,37127,1473,929,677,156,544,1473,1.0,0.6306856754921928,0.3693143245078072,640,0.4596062457569586,0.10590631364562118,0.4344874405974202
1738,37127,6575,2899,2518,1403,3676,6575,1.0,0.4409125475285171,0.5590874524714828,2654,0.3829657794676806,0.21338403041825096,0.40365019011406844
1739,37127,4436,975,1069,1933,3461,4436,1.0,0.21979260595130748,0.7802073940486925,1434,0.24098286744815148,0.43575293056807934,0.32326420198376915
1740,37127,886,165,207,449,721,886,1.0,0.18623024830699775,0.8137697516930023,230,0.23363431151241534,0.5067720090293454,0.2595936794582393
1741,37127,2777,166,321,1670,2611,2777,1.0,0.05977673748649622,0.9402232625135037,786,0.11559236586244148,0.6013683831472812,0.28303925099027727
1742,37127,2299,383,448,745,1916,2299,1.0,0.16659417137886037,0.8334058286211397,1106,0.1948673336233145,0.3240539364941279,0.4810787298825576
1743,37127,2422,1901,1454,200,521,2422,1.0,0.7848885218827415,0.21511147811725848,768,0.6003303055326177,0.08257638315441784,0.3170933113129645
1744,37127,3777,1253,1329,1344,2524,3777,1.0,0.3317447709822611,0.6682552290177389,1104,0.35186656076250994,0.35583796664019063,0.29229547259729943
1745,37127,1942,1062,875,429,880,1942,1.0,0.5468589083419155,0.45314109165808447,638,0.4505664263645726,0.22090628218331618,0.32852729145211124
1746,37127,3864,2780,2158,376,1084,3864,1.0,0.7194616977225673,0.2805383022774327,1330,0.5584886128364389,0.09730848861283643,0.3442028985507246
1747,37127,3285,1283,1302,901,2002,3285,1.0,0.39056316590563167,0.6094368340943683,1082,0.3963470319634703,0.27427701674277016,0.3293759512937595
1748,37127,1176,567,490,356,609,1176,1.0,0.48214285714285715,0.5178571428571429,330,0.4166666666666667,0.30272108843537415,0.28061224489795916
1749,37127,2149,365,444,799,1784,2149,1.0,0.1698464402047464,0.8301535597952536,906,0.20660772452303397,0.3718008375988832,0.42159143787808284
1750,37127,3255,656,709,1169,2599,3255,1.0,0.20153609831029187,0.7984639016897082,1377,0.21781874039938556,0.35913978494623655,0.42304147465437786
1751,37129,3653,647,704,1146,3006,3653,1.0,0.17711470024637285,0.8228852997536271,1803,0.192718313714755,0.3137147549958938,0.4935669312893512
1752,37129,1720,10,480,743,1710,1720,1.0,0.005813953488372093,0.9941860465116279,497,0.27906976744186046,0.43197674418604654,0.288953488372093
1753,37129,2740,18,809,977,2722,2740,1.0,0.006569343065693431,0.9934306569343065,954,0.29525547445255473,0.35656934306569343,0.34817518248175183
1754,37129,3965,1092,1315,1179,2873,3965,1.0,0.2754098360655738,0.7245901639344262,1471,0.3316519546027743,0.2973518284993695,0.3709962168978562
1755,37129,5330,936,1539,1230,4394,5330,1.0,0.17560975609756097,0.824390243902439,2561,0.28874296435272045,0.23076923076923078,0.48048780487804876
1756,37129,4125,338,969,1404,3787,4125,1.0,0.08193939393939394,0.918060606060606,1752,0.2349090909090909,0.34036363636363637,0.42472727272727273
1757,37129,10091,1362,2806,3445,8729,10091,1.0,0.1349717570111981,0.8650282429888019,3840,0.2780695669408384,0.34139332078089385,0.38053711227826775
1758,37129,6570,196,1670,3410,6374,6570,1.0,0.029832572298325723,0.9701674277016743,1490,0.2541856925418569,0.5190258751902588,0.2267884322678843
1759,37129,2162,6,569,1067,2156,2162,1.0,0.0027752081406105457,0.9972247918593895,526,0.2631822386679001,0.4935245143385754,0.2432932469935245
1760,37129,8844,409,2063,3354,8435,8844,1.0,0.04624604251469923,0.9537539574853008,3427,0.2332654907281773,0.37924016282225237,0.3874943464495703
1761,37129,6226,388,1836,2624,5838,6226,1.0,0.062319306135560554,0.9376806938644394,1766,0.29489238676517826,0.42145840025698683,0.2836492129778349
1762,37129,4314,236,1057,1664,4078,4314,1.0,0.054705609643022714,0.9452943903569773,1593,0.24501622624014835,0.3857209086694483,0.36926286509040335
1763,37129,2487,310,824,1007,2177,2487,1.0,0.12464817048652996,0.87535182951347,656,0.3313228789706474,0.4049055086449538,0.2637716123843989
1764,37129,5462,167,1633,2748,5295,5462,1.0,0.03057488099597217,0.9694251190040278,1081,0.29897473452947637,0.5031124130355181,0.1979128524350055
1765,37129,4669,118,1302,2216,4551,4669,1.0,0.025273077746840865,0.9747269222531592,1151,0.27886056971514245,0.4746198329406725,0.24651959734418505
1766,37129,2043,17,543,916,2026,2043,1.0,0.008321096426823299,0.9916789035731767,584,0.2657856093979442,0.44836025452765543,0.2858541360744004
1767,37129,6847,1098,1684,2323,5749,6847,1.0,0.16036220242441945,0.8396377975755805,2840,0.24594713012998393,0.33927267416386736,0.41478019570614866
1768,37129,3318,382,917,1112,2936,3318,1.0,0.11512959614225438,0.8848704038577456,1289,0.27637130801687765,0.3351416515973478,0.3884870403857746
1769,37129,3632,1584,2075,382,2048,3632,1.0,0.43612334801762115,0.5638766519823789,1175,0.5713105726872246,0.10517621145374449,0.3235132158590308
1770,37129,2300,867,971,400,1433,2300,1.0,0.3769565217391304,0.6230434782608696,929,0.4221739130434783,0.17391304347826086,0.40391304347826085
1771,37129,6461,2460,2406,619,4001,6461,1.0,0.38074601454883145,0.6192539854511685,3436,0.3723881752050766,0.09580560284785637,0.5318062219470671
1772,37129,3695,2862,2467,95,833,3695,1.0,0.7745602165087957,0.22543978349120433,1133,0.66765899864682,0.02571041948579161,0.30663058186738834
1773,37129,3182,953,1714,457,2229,3182,1.0,0.29949717159019484,0.7005028284098052,1011,0.5386549340037712,0.1436203645505971,0.3177247014456317
1774,37129,2141,1069,1363,189,1072,2141,1.0,0.4992993928070995,0.5007006071929005,589,0.6366184026156002,0.08827650630546474,0.2751050910789351
1775,37129,3312,453,1029,579,2859,3312,1.0,0.13677536231884058,0.8632246376811594,1704,0.31068840579710144,0.17481884057971014,0.5144927536231884
1776,37129,3852,151,1023,1713,3701,3852,1.0,0.03920041536863967,0.9607995846313603,1116,0.26557632398753894,0.4447040498442368,0.2897196261682243
1777,37129,2039,339,602,632,1700,2039,1.0,0.1662579695929377,0.8337420304070623,805,0.295242766061795,0.30995586071603726,0.39480137322216774
1778,37129,3860,156,992,1486,3704,3860,1.0,0.04041450777202073,0.9595854922279793,1382,0.25699481865284973,0.3849740932642487,0.35803108808290157
1779,37129,1885,226,724,603,1659,1885,1.0,0.11989389920424404,0.880106100795756,558,0.3840848806366048,0.31989389920424405,0.29602122015915117
1780,37129,5075,83,1453,2487,4992,5075,1.0,0.016354679802955664,0.9836453201970443,1135,0.28630541871921183,0.49004926108374386,0.22364532019704433
1781,37129,4004,517,1226,752,3487,4004,1.0,0.12912087912087913,0.8708791208791209,2026,0.3061938061938062,0.1878121878121878,0.505994005994006
1782,37129,3101,54,615,1913,3047,3101,1.0,0.017413737504030958,0.982586262495969,573,0.1983231215736859,0.6168977749113189,0.18477910351499516
1783,37129,3079,809,860,280,2270,3079,1.0,0.26274764533939593,0.7372523546606041,1939,0.27931146476128615,0.09093861643390712,0.6297499188048068
1784,37129,3788,95,864,1660,3693,3788,1.0,0.0250791974656811,0.9749208025343189,1264,0.22808870116156282,0.4382259767687434,0.33368532206969376
1785,37129,7558,566,1586,1143,6992,7558,1.0,0.07488753638528711,0.9251124636147129,4829,0.20984387404075153,0.15123048425509394,0.6389256417041546
1786,37129,1877,65,501,583,1812,1877,1.0,0.03462972828982419,0.9653702717101759,793,0.2669152903569526,0.3106020245071923,0.4224826851358551
1787,37129,4248,294,1228,1380,3954,4248,1.0,0.0692090395480226,0.9307909604519774,1640,0.2890772128060264,0.3248587570621469,0.3860640301318267
1788,37129,5486,157,1244,2219,5329,5486,1.0,0.02861830113014947,0.9713816988698505,2023,0.22675902296755376,0.4044841414509661,0.36875683558148015
1789,37129,3113,111,1005,1248,3002,3113,1.0,0.03565692258271764,0.9643430774172823,860,0.32283970446514615,0.4008994539029875,0.27626084163186637
1790,37131,467,216,168,108,251,467,1.0,0.4625267665952891,0.5374732334047109,191,0.35974304068522484,0.23126338329764454,0.4089935760171306
1791,37131,597,403,147,40,194,597,1.0,0.6750418760469011,0.3249581239530988,410,0.24623115577889448,0.06700167504187604,0.6867671691792295
1792,37131,1402,418,470,514,984,1402,1.0,0.29814550641940085,0.7018544935805991,418,0.33523537803138376,0.3666191155492154,0.29814550641940085
1793,37131,3249,2031,1479,451,1218,3249,1.0,0.6251154201292706,0.37488457987072943,1319,0.4552169898430286,0.13881194213604187,0.4059710680209295
1794,37131,1206,779,551,226,427,1206,1.0,0.6459369817578773,0.3540630182421227,429,0.45688225538971805,0.18739635157545606,0.35572139303482586
1795,37131,1617,1153,883,202,464,1617,1.0,0.7130488559059988,0.28695114409400124,532,0.5460729746444032,0.12492269635126778,0.329004329004329
1796,37131,530,212,151,128,318,530,1.0,0.4,0.6,251,0.2849056603773585,0.24150943396226415,0.47358490566037736
1797,37131,471,308,204,62,163,471,1.0,0.6539278131634819,0.346072186836518,205,0.43312101910828027,0.1316348195329087,0.43524416135881105
1798,37131,1729,1523,1172,112,206,1729,1.0,0.8808559861191441,0.11914401388085599,445,0.6778484673221515,0.06477732793522267,0.2573742047426258
1799,37131,745,355,255,219,390,745,1.0,0.47651006711409394,0.5234899328859061,271,0.3422818791946309,0.29395973154362415,0.363758389261745
1800,37131,680,239,203,191,441,680,1.0,0.3514705882352941,0.6485294117647059,286,0.2985294117647059,0.28088235294117647,0.42058823529411765
1801,37131,228,116,99,81,112,228,1.0,0.5087719298245614,0.49122807017543857,48,0.4342105263157895,0.35526315789473684,0.21052631578947367
1802,37131,991,476,370,163,515,991,1.0,0.4803229061553986,0.5196770938446014,458,0.37336024217961655,0.16448032290615539,0.46215943491422806
1803,37131,859,483,365,208,376,859,1.0,0.5622817229336438,0.43771827706635624,286,0.42491268917345754,0.2421420256111758,0.3329452852153667
1804,37131,692,248,215,250,444,692,1.0,0.3583815028901734,0.6416184971098265,227,0.3106936416184971,0.36127167630057805,0.32803468208092484
1805,37131,816,501,146,72,315,816,1.0,0.6139705882352942,0.3860294117647059,598,0.17892156862745098,0.08823529411764706,0.7328431372549019
1806,37131,942,342,284,321,600,942,1.0,0.3630573248407643,0.6369426751592356,337,0.30148619957537154,0.34076433121019106,0.35774946921443734
1807,37131,278,68,62,133,210,278,1.0,0.2446043165467626,0.7553956834532374,83,0.22302158273381295,0.4784172661870504,0.29856115107913667
1808,37133,1710,77,212,648,1633,1710,1.0,0.04502923976608187,0.9549707602339181,850,0.1239766081871345,0.37894736842105264,0.49707602339181284
1809,37133,3207,54,420,1442,3153,3207,1.0,0.01683816651075772,0.9831618334892422,1345,0.13096351730589337,0.4496414094169005,0.4193950732772061
1810,37133,5001,138,773,2088,4863,5001,1.0,0.027594481103779243,0.9724055188962207,2140,0.15456908618276344,0.4175164967006599,0.4279144171165767
1811,37133,12767,2484,2546,2641,10283,12767,1.0,0.19456411059763454,0.8054358894023654,7580,0.19942038066891205,0.2068614396490953,0.5937181796819926
1812,37133,6979,1104,916,1796,5875,6979,1.0,0.15818885227109902,0.841811147728901,4267,0.13125089554377417,0.2573434589482734,0.6114056455079524
1813,37133,3380,1779,1050,163,1601,3380,1.0,0.5263313609467456,0.47366863905325446,2167,0.3106508875739645,0.048224852071005915,0.6411242603550296
1814,37133,4714,470,967,2128,4244,4714,1.0,0.09970301230377598,0.900296987696224,1619,0.20513364446330082,0.45142129826050065,0.34344505727619856
1815,37133,10414,2291,2053,2180,8123,10414,1.0,0.21999231803341657,0.7800076819665834,6181,0.1971384674476666,0.2093335893988861,0.5935279431534473
1816,37133,5717,792,896,2131,4925,5717,1.0,0.13853419625677804,0.861465803743222,2690,0.15672555536120342,0.37274794472625505,0.47052649991254153
1817,37133,11512,2398,2173,2417,9114,11512,1.0,0.20830437804030577,0.7916956219596942,6922,0.1887595552466991,0.209954829742877,0.6012856150104239
1818,37133,26979,3273,959,1057,23706,26979,1.0,0.12131657956188147,0.8786834204381185,24963,0.035546165536157755,0.03917862040846584,0.9252752140553764
1819,37133,4291,620,699,1558,3671,4291,1.0,0.14448846422745282,0.8555115357725472,2034,0.16289909112095083,0.36308552784898623,0.4740153810300629
1820,37133,1948,161,210,836,1787,1948,1.0,0.08264887063655031,0.9173511293634496,902,0.10780287474332649,0.42915811088295686,0.46303901437371664
1821,37133,1367,260,228,448,1107,1367,1.0,0.19019751280175567,0.8098024871982443,691,0.1667885881492319,0.32772494513533285,0.5054864667154353
1822,37133,5739,302,615,1683,5437,5739,1.0,0.052622408085032234,0.9473775919149677,3441,0.10716152639832724,0.2932566649242028,0.5995818086774699
1823,37133,4065,613,710,1330,3452,4065,1.0,0.15079950799507996,0.8492004920049201,2025,0.17466174661746617,0.32718327183271834,0.4981549815498155
1824,37133,2408,218,248,815,2190,2408,1.0,0.09053156146179402,0.909468438538206,1345,0.10299003322259136,0.3384551495016611,0.5585548172757475
1825,37133,2932,193,282,1013,2739,2932,1.0,0.06582537517053207,0.9341746248294679,1637,0.09618008185538882,0.3454979536152797,0.5583219645293315
1826,37133,1390,102,132,615,1288,1390,1.0,0.07338129496402877,0.9266187050359712,643,0.09496402877697842,0.44244604316546765,0.46258992805755395
1827,37133,3748,280,376,1070,3468,3748,1.0,0.07470651013874066,0.9252934898612594,2302,0.10032017075773746,0.2854855923159018,0.6141942369263608
1828,37133,5784,1131,1154,1511,4653,5784,1.0,0.19553941908713693,0.8044605809128631,3119,0.19951590594744123,0.26123789764868605,0.5392461964038727
1829,37133,2681,332,378,957,2349,2681,1.0,0.123834390152928,0.876165609847072,1346,0.1409921671018277,0.35695635956732563,0.5020514733308467
1830,37133,4101,142,493,1716,3959,4101,1.0,0.03462570104852475,0.9653742989514752,1892,0.1202145818093148,0.41843452816386245,0.4613508900268227
1831,37135,3273,492,1592,159,2781,3273,1.0,0.15032080659945005,0.84967919340055,1522,0.48640391078521233,0.04857928505957837,0.4650168041552093
1832,37135,2706,284,1073,432,2422,2706,1.0,0.1049519586104952,0.8950480413895048,1201,0.39652623798965264,0.15964523281596452,0.44382852919438287
1833,37135,2754,180,1273,346,2574,2754,1.0,0.06535947712418301,0.934640522875817,1135,0.46223674655047203,0.12563543936092955,0.4121278140885984
1834,37135,3351,205,1569,981,3146,3351,1.0,0.061175768427335124,0.9388242315726649,801,0.468218442256043,0.2927484333034915,0.23903312444046554
1835,37135,2224,167,1435,287,2057,2224,1.0,0.07508992805755396,0.924910071942446,502,0.6452338129496403,0.12904676258992806,0.22571942446043167
1836,37135,2315,81,1217,532,2234,2315,1.0,0.03498920086393088,0.9650107991360691,566,0.5257019438444924,0.22980561555075593,0.24449244060475162
1837,37135,2044,273,1238,385,1771,2044,1.0,0.13356164383561644,0.8664383561643836,421,0.6056751467710372,0.18835616438356165,0.20596868884540118
1838,37135,1793,214,1018,222,1579,1793,1.0,0.11935303959843838,0.8806469604015617,553,0.5677635248187396,0.1238148354712772,0.30842163970998326
1839,37135,1139,303,400,380,836,1139,1.0,0.2660228270412643,0.7339771729587358,359,0.35118525021949076,0.33362598770851626,0.315188762071993
1840,37135,1547,260,598,541,1287,1547,1.0,0.16806722689075632,0.8319327731092437,408,0.3865546218487395,0.34970911441499675,0.26373626373626374
1841,37135,1814,130,860,212,1684,1814,1.0,0.07166482910694598,0.9283351708930541,742,0.474090407938258,0.11686879823594266,0.40904079382579933
1842,37135,2002,33,1574,367,1969,2002,1.0,0.016483516483516484,0.9835164835164835,61,0.7862137862137862,0.18331668331668333,0.030469530469530468
1843,37135,3396,488,1704,459,2908,3396,1.0,0.143698468786808,0.856301531213192,1233,0.5017667844522968,0.1351590106007067,0.3630742049469965
1844,37135,908,44,603,143,864,908,1.0,0.048458149779735685,0.9515418502202643,162,0.6640969162995595,0.15748898678414097,0.17841409691629956
1845,37135,2816,256,1572,334,2560,2816,1.0,0.09090909090909091,0.9090909090909091,910,0.5582386363636364,0.11860795454545454,0.3231534090909091
1846,37135,3996,598,1527,875,3398,3996,1.0,0.14964964964964966,0.8503503503503503,1594,0.38213213213213215,0.21896896896896897,0.3988988988988989
1847,37135,2681,517,1320,259,2164,2681,1.0,0.1928384930995897,0.8071615069004103,1102,0.4923535994032078,0.09660574412532637,0.41104065647146587
1848,37135,3538,255,2065,437,3283,3538,1.0,0.07207461842849067,0.9279253815715093,1036,0.5836630864895421,0.12351611079706049,0.2928208027133974
1849,37135,2740,214,937,300,2526,2740,1.0,0.0781021897810219,0.9218978102189781,1503,0.34197080291970805,0.10948905109489052,0.5485401459854015
1850,37135,2883,405,1685,179,2478,2883,1.0,0.1404786680541103,0.8595213319458896,1019,0.584460631286854,0.062088102670828996,0.353451266042317
1851,37135,1164,96,837,152,1068,1164,1.0,0.08247422680412371,0.9175257731958762,175,0.7190721649484536,0.13058419243986255,0.15034364261168384
1852,37135,1854,293,853,469,1561,1854,1.0,0.15803667745415317,0.8419633225458468,532,0.46008629989212513,0.2529665587918015,0.28694714131607335
1853,37135,1535,89,1114,162,1446,1535,1.0,0.057980456026058634,0.9420195439739414,259,0.7257328990228012,0.10553745928338762,0.16872964169381108
1854,37135,2437,219,996,1100,2218,2437,1.0,0.0898645876077144,0.9101354123922856,341,0.4086992203528929,0.45137464095199015,0.13992613869511694
1855,37135,1732,89,1200,430,1643,1732,1.0,0.05138568129330254,0.9486143187066974,102,0.6928406466512702,0.24826789838337182,0.05889145496535797
1856,37135,5071,1098,1765,1556,3973,5071,1.0,0.2165253401695918,0.7834746598304082,1750,0.3480575823309012,0.30684283178860183,0.34509958588049694
1857,37135,2853,320,2014,641,2533,2853,1.0,0.11216263582194182,0.8878373641780581,198,0.7059235892043463,0.2246757798808272,0.0694006309148265
1858,37135,1072,254,626,157,818,1072,1.0,0.23694029850746268,0.7630597014925373,289,0.5839552238805971,0.146455223880597,0.269589552238806
1859,37135,2896,350,1261,485,2546,2896,1.0,0.12085635359116022,0.8791436464088398,1150,0.4354281767955801,0.16747237569060774,0.39709944751381215
1860,37135,4442,248,2394,1064,4194,4442,1.0,0.055830706888788835,0.9441692931112111,984,0.5389464205312922,0.2395317424583521,0.2215218370103557
1861,37135,2455,448,1843,437,2007,2455,1.0,0.1824847250509165,0.8175152749490835,175,0.7507128309572302,0.1780040733197556,0.07128309572301425
1862,37135,1410,329,556,503,1081,1410,1.0,0.23333333333333334,0.7666666666666667,351,0.3943262411347518,0.3567375886524823,0.24893617021276596
1863,37135,2839,266,1678,287,2573,2839,1.0,0.09369496301514618,0.9063050369848539,874,0.5910531877421628,0.10109193377949982,0.3078548784783374
1864,37135,2630,286,1208,1065,2344,2630,1.0,0.10874524714828897,0.8912547528517111,357,0.45931558935361216,0.4049429657794677,0.13574144486692016
1865,37135,3193,195,938,924,2998,3193,1.0,0.06107109301597244,0.9389289069840275,1331,0.2937676166614469,0.2893830253679925,0.4168493579705606
1866,37135,2220,238,1221,322,1982,2220,1.0,0.10720720720720721,0.8927927927927928,677,0.55,0.14504504504504503,0.30495495495495495
1867,37135,1999,247,1437,78,1752,1999,1.0,0.12356178089044523,0.8764382191095548,484,0.7188594297148574,0.03901950975487744,0.24212106053026514
1868,37135,2615,157,1298,463,2458,2615,1.0,0.060038240917782024,0.939961759082218,854,0.49636711281070744,0.17705544933078393,0.3265774378585086
1869,37135,2690,86,1710,430,2604,2690,1.0,0.03197026022304833,0.9680297397769517,550,0.6356877323420075,0.15985130111524162,0.20446096654275092
1870,37135,1502,48,797,489,1454,1502,1.0,0.03195739014647137,0.9680426098535286,216,0.5306258322237017,0.3255659121171771,0.14380825565912117
1871,37135,2713,214,750,1288,2499,2713,1.0,0.07887946922226317,0.9211205307777368,675,0.27644673792849245,0.47475119793586434,0.2488020641356432
1872,37135,1980,267,708,760,1713,1980,1.0,0.13484848484848486,0.8651515151515151,512,0.3575757575757576,0.3838383838383838,0.2585858585858586
1873,37135,2610,1087,1437,447,1523,2610,1.0,0.4164750957854406,0.5835249042145594,726,0.5505747126436782,0.17126436781609194,0.27816091954022987
1874,37137,500,252,198,110,248,500,1.0,0.504,0.496,192,0.396,0.22,0.384
1875,37137,2267,305,577,993,1962,2267,1.0,0.1345390383767093,0.8654609616232907,697,0.2545213939126599,0.43802382002646667,0.3074547860608734
1876,37137,1859,202,632,850,1657,1859,1.0,0.10866057019903173,0.8913394298009683,377,0.3399677245831092,0.457235072619688,0.20279720279720279
1877,37137,302,2,8,133,300,302,1.0,0.006622516556291391,0.9933774834437086,161,0.026490066225165563,0.44039735099337746,0.5331125827814569
1878,37137,1428,148,212,657,1280,1428,1.0,0.10364145658263306,0.896358543417367,559,0.1484593837535014,0.46008403361344535,0.3914565826330532
1879,37137,1721,179,267,695,1542,1721,1.0,0.10400929692039512,0.8959907030796049,759,0.15514235909355026,0.40383497966298665,0.4410226612434631
1880,37137,2105,966,611,423,1139,2105,1.0,0.45890736342042754,0.5410926365795724,1071,0.2902612826603325,0.20095011876484561,0.5087885985748218
1881,37137,608,149,142,190,459,608,1.0,0.2450657894736842,0.7549342105263158,276,0.23355263157894737,0.3125,0.45394736842105265
1882,37139,1731,530,619,549,1201,1731,1.0,0.30618139803581745,0.6938186019641825,563,0.35759676487579434,0.317157712305026,0.3252455228191797
1883,37139,1305,180,271,506,1125,1305,1.0,0.13793103448275862,0.8620689655172413,528,0.20766283524904214,0.38773946360153255,0.4045977011494253
1884,37139,2840,1865,1374,193,975,2840,1.0,0.6566901408450704,0.34330985915492956,1273,0.4838028169014085,0.06795774647887325,0.4482394366197183
1885,37139,1731,578,475,277,1153,1731,1.0,0.3339110340843443,0.6660889659156557,979,0.27440785673021373,0.16002310803004044,0.5655690352397458
1886,37139,3729,654,892,1626,3075,3729,1.0,0.1753821399839099,0.82461786001609,1211,0.23920622150710646,0.4360418342719228,0.32475194422097076
1887,37139,3961,1074,1294,1258,2887,3961,1.0,0.27114365059328455,0.7288563494067155,1409,0.32668518050997225,0.31759656652360513,0.3557182529664226
1888,37139,2111,815,713,508,1296,2111,1.0,0.3860729512079583,0.6139270487920417,890,0.3377546186641402,0.24064424443391758,0.42160113690194223
1889,37139,1466,1085,815,76,381,1466,1.0,0.7401091405184175,0.2598908594815825,575,0.5559345156889495,0.05184174624829468,0.3922237380627558
1890,37139,1548,1307,854,15,241,1548,1.0,0.8443152454780362,0.15568475452196381,679,0.5516795865633075,0.009689922480620155,0.43863049095607237
1891,37139,1694,800,633,306,894,1694,1.0,0.4722550177095632,0.5277449822904369,755,0.37367178276269186,0.1806375442739079,0.44569067296340026
1892,37139,1684,709,581,253,975,1684,1.0,0.42102137767220904,0.578978622327791,850,0.34501187648456055,0.1502375296912114,0.504750593824228
1893,37139,1409,635,514,166,774,1409,1.0,0.45067423704755144,0.5493257629524485,729,0.3647977288857346,0.11781405251951739,0.517388218594748
1894,37139,6253,1542,1247,1900,4711,6253,1.0,0.24660163121701584,0.7533983687829842,3106,0.19942427634735327,0.30385415000799615,0.4967215736446506
1895,37141,3288,312,567,1159,2976,3288,1.0,0.0948905109489051,0.9051094890510949,1562,0.17244525547445255,0.3524939172749392,0.4750608272506083
1896,37141,1725,895,734,333,830,1725,1.0,0.518840579710145,0.4811594202898551,658,0.4255072463768116,0.19304347826086957,0.3814492753623188
1897,37141,1108,271,320,326,837,1108,1.0,0.24458483754512636,0.7554151624548736,462,0.2888086642599278,0.29422382671480146,0.41696750902527074
1898,37141,297,110,115,69,187,297,1.0,0.37037037037037035,0.6296296296296297,113,0.3872053872053872,0.23232323232323232,0.38047138047138046
1899,37141,1828,606,535,443,1222,1828,1.0,0.33150984682713347,0.6684901531728665,850,0.2926695842450766,0.24234135667396062,0.4649890590809628
1900,37141,1739,323,381,620,1416,1739,1.0,0.18573893041978148,0.8142610695802185,738,0.2190914318573893,0.35652673950546293,0.4243818286371478
1901,37141,1331,207,231,513,1124,1331,1.0,0.1555221637866266,0.8444778362133734,587,0.17355371900826447,0.3854244928625094,0.44102178812922616
1902,37141,430,18,70,179,412,430,1.0,0.04186046511627907,0.958139534883721,181,0.16279069767441862,0.41627906976744183,0.42093023255813955
1903,37141,2494,194,662,1276,2300,2494,1.0,0.07778668805132317,0.9222133119486768,556,0.2654370489174018,0.5116279069767442,0.22293504410585405
1904,37141,2904,867,590,677,2037,2904,1.0,0.29855371900826444,0.7014462809917356,1637,0.20316804407713498,0.2331267217630854,0.5637052341597796
1905,37141,496,57,77,219,439,496,1.0,0.11491935483870967,0.8850806451612904,200,0.15524193548387097,0.4415322580645161,0.4032258064516129
1906,37141,2711,552,609,587,2159,2711,1.0,0.2036149022500922,0.7963850977499077,1515,0.22464035411287347,0.216525267428993,0.5588343784581336
1907,37141,3655,1070,1025,1120,2585,3655,1.0,0.292749658002736,0.707250341997264,1510,0.280437756497948,0.3064295485636115,0.4131326949384405
1908,37141,3004,153,657,1290,2851,3004,1.0,0.050932090545938745,0.9490679094540613,1057,0.21870838881491345,0.42942743009320905,0.3518641810918775
1909,37141,1599,15,278,940,1584,1599,1.0,0.009380863039399626,0.9906191369606003,381,0.17385866166353972,0.5878674171357098,0.23827392120075047
1910,37141,2905,220,632,1220,2685,2905,1.0,0.0757314974182444,0.9242685025817556,1053,0.21755593803786574,0.4199655765920826,0.3624784853700516
1911,37141,763,513,457,139,250,763,1.0,0.672346002621232,0.32765399737876805,167,0.598951507208388,0.182175622542595,0.21887287024901703
1912,37141,3564,73,719,1691,3491,3564,1.0,0.02048260381593715,0.9795173961840629,1154,0.20173961840628507,0.4744668911335578,0.32379349046015715
1913,37141,1429,463,384,365,966,1429,1.0,0.32400279916025193,0.6759972008397481,680,0.26871938418474456,0.2554233729881036,0.47585724282715186
1914,37141,3058,146,589,1451,2912,3058,1.0,0.04774362328319163,0.9522563767168084,1018,0.19260954872465663,0.47449313276651406,0.3328973185088293
1915,37143,2058,664,608,676,1394,2058,1.0,0.3226433430515063,0.6773566569484937,774,0.2954324586977648,0.32847424684159376,0.3760932944606414
1916,37143,766,152,162,315,614,766,1.0,0.19843342036553524,0.8015665796344648,289,0.21148825065274152,0.4112271540469974,0.3772845953002611
1917,37143,268,50,50,107,218,268,1.0,0.1865671641791045,0.8134328358208955,111,0.1865671641791045,0.39925373134328357,0.4141791044776119
1918,37143,2971,364,684,1210,2607,2971,1.0,0.12251767081790643,0.8774823291820936,1077,0.2302255132951868,0.40727027936721644,0.36250420733759675
1919,37143,1143,570,488,267,573,1143,1.0,0.49868766404199477,0.5013123359580053,388,0.42694663167104113,0.2335958005249344,0.3394575678040245
1920,37143,1078,268,254,312,810,1078,1.0,0.24860853432282004,0.75139146567718,512,0.23562152133580705,0.2894248608534323,0.4749536178107607
1921,37143,2400,425,513,935,1975,2400,1.0,0.17708333333333334,0.8229166666666666,952,0.21375,0.38958333333333334,0.39666666666666667
1922,37145,1178,206,251,485,972,1178,1.0,0.17487266553480477,0.8251273344651953,442,0.21307300509337862,0.41171477079796265,0.37521222410865873
1923,37145,2684,1195,949,471,1489,2684,1.0,0.44523099850968706,0.5547690014903129,1264,0.35357675111773473,0.1754843517138599,0.47093889716840537
1924,37145,1144,431,426,337,713,1144,1.0,0.3767482517482518,0.6232517482517482,381,0.3723776223776224,0.2945804195804196,0.333041958041958
1925,37145,2066,459,518,775,1607,2066,1.0,0.22216844143272024,0.7778315585672798,773,0.25072604065827686,0.3751210067763795,0.37415295256534364
1926,37145,2544,343,574,1105,2201,2544,1.0,0.13482704402515724,0.8651729559748428,865,0.22562893081761007,0.4343553459119497,0.3400157232704403
1927,37145,5425,747,1096,2343,4678,5425,1.0,0.1376958525345622,0.8623041474654378,1986,0.20202764976958526,0.431889400921659,0.36608294930875573
1928,37145,1808,657,689,451,1151,1808,1.0,0.3633849557522124,0.6366150442477876,668,0.3810840707964602,0.24944690265486727,0.3694690265486726
1929,37145,2557,749,640,724,1808,2557,1.0,0.2929213922565507,0.7070786077434493,1193,0.2502933124755573,0.28314430973797416,0.46656237778646853
1930,37145,2284,519,597,949,1765,2284,1.0,0.22723292469352013,0.7727670753064798,738,0.2613835376532399,0.4154991243432574,0.3231173380035026
1931,37145,2519,1270,1037,435,1249,2519,1.0,0.5041683207622072,0.49583167923779276,1047,0.41167129813418024,0.17268757443429933,0.41564112743152043
1932,37145,819,198,219,294,621,819,1.0,0.24175824175824176,0.7582417582417582,306,0.2673992673992674,0.358974358974359,0.37362637362637363
1933,37145,2328,754,769,669,1574,2328,1.0,0.3238831615120275,0.6761168384879725,890,0.33032646048109965,0.28737113402061853,0.38230240549828176
1934,37145,1251,194,288,617,1057,1251,1.0,0.1550759392486011,0.8449240607513989,346,0.2302158273381295,0.49320543565147884,0.2765787370103917
1935,37145,1743,246,365,841,1497,1743,1.0,0.14113597246127366,0.8588640275387264,537,0.20940906483075158,0.4825014343086632,0.3080895008605852
1936,37147,3305,622,831,468,2683,3305,1.0,0.1881996974281392,0.8118003025718609,2006,0.2514372163388805,0.1416036308623298,0.6069591527987898
1937,37147,2982,660,766,1154,2322,2982,1.0,0.22132796780684105,0.778672032193159,1062,0.25687458081824277,0.3869885982562039,0.3561368209255533
1938,37147,5688,1444,1804,2395,4244,5688,1.0,0.2538677918424754,0.7461322081575246,1489,0.3171589310829817,0.4210618846694796,0.26177918424753865
1939,37147,3628,1055,911,1165,2573,3628,1.0,0.2907938257993385,0.7092061742006616,1552,0.25110253583241454,0.3211135611907387,0.42778390297684676
1940,37147,2725,1368,1140,582,1357,2725,1.0,0.5020183486238532,0.4979816513761468,1003,0.41834862385321103,0.21357798165137615,0.3680733944954128
1941,37147,5622,2698,2036,821,2924,5622,1.0,0.479900391319815,0.520099608680185,2765,0.36214870152970474,0.14603344005691923,0.491817858413376
1942,37147,7468,4301,3590,928,3167,7468,1.0,0.575923942153187,0.42407605784681307,2950,0.4807177289769684,0.1242635243706481,0.3950187466523835
1943,37147,4655,1144,1748,2024,3511,4655,1.0,0.24575725026852846,0.7542427497314715,883,0.37551020408163266,0.4348012889366273,0.18968850698174006
1944,37147,1803,1376,813,44,427,1803,1.0,0.7631724902939545,0.2368275097060455,946,0.4509151414309484,0.024403771491957847,0.5246810870770937
1945,37147,4839,537,748,2365,4302,4839,1.0,0.11097334159950403,0.889026658400496,1726,0.15457739202314527,0.4887373424261211,0.3566852655507336
1946,37147,2715,1070,915,856,1645,2715,1.0,0.39410681399631675,0.6058931860036832,944,0.3370165745856354,0.3152854511970534,0.34769797421731125
1947,37147,5468,993,1190,1174,4475,5468,1.0,0.1816020482809071,0.8183979517190929,3104,0.21762984637893196,0.2147037307973665,0.5676664228237015
1948,37147,1986,460,495,949,1526,1986,1.0,0.23162134944612287,0.7683786505538771,542,0.24924471299093656,0.4778449144008056,0.2729103726082578
1949,37147,3170,2073,1684,207,1097,3170,1.0,0.6539432176656151,0.34605678233438486,1279,0.5312302839116719,0.06529968454258675,0.40347003154574135
1950,37147,3766,1493,1391,1201,2273,3766,1.0,0.39644184811471056,0.6035581518852894,1174,0.3693574083908656,0.3189060010621349,0.3117365905469995
1951,37147,3014,2491,1925,96,523,3014,1.0,0.8264764432647644,0.17352355673523556,993,0.6386861313868614,0.03185136031851361,0.3294625082946251
1952,37147,2160,248,543,367,1912,2160,1.0,0.11481481481481481,0.8851851851851852,1250,0.2513888888888889,0.1699074074074074,0.5787037037037037
1953,37147,2562,1137,953,276,1425,2562,1.0,0.44379391100702575,0.5562060889929742,1333,0.37197501951600315,0.10772833723653395,0.5202966432474629
1954,37147,3889,2082,1334,414,1807,3889,1.0,0.5353561326819234,0.4646438673180766,2141,0.34301877089226024,0.1064541013113911,0.5505271277963487
1955,37147,2806,326,886,1175,2480,2806,1.0,0.11617961511047754,0.8838203848895224,745,0.315751960085531,0.4187455452601568,0.2655024946543122
1956,37147,3188,636,909,1281,2552,3188,1.0,0.19949811794228356,0.8005018820577164,998,0.28513174404015057,0.4018193224592221,0.31304893350062735
1957,37147,2335,258,662,1115,2077,2335,1.0,0.11049250535331906,0.889507494646681,558,0.28351177730192717,0.47751605995717344,0.23897216274089936
1958,37147,1283,107,198,541,1176,1283,1.0,0.08339828526890102,0.916601714731099,544,0.1543257989088075,0.421667965705378,0.4240062353858145
1959,37147,2843,578,902,1303,2265,2843,1.0,0.20330636651424552,0.7966936334857545,638,0.31727048892015475,0.4583186774533943,0.22441083362645092
1960,37147,3116,419,921,1562,2697,3116,1.0,0.13446726572528883,0.8655327342747111,633,0.2955712451861361,0.5012836970474968,0.20314505776636713
1961,37147,6417,1298,1676,1447,5119,6417,1.0,0.2022752064827801,0.7977247935172199,3294,0.2611812373383201,0.22549477949197444,0.5133239831697055
1962,37147,1516,504,446,462,1012,1516,1.0,0.3324538258575198,0.6675461741424802,608,0.2941952506596306,0.30474934036939316,0.40105540897097625
1963,37147,1569,491,374,545,1078,1569,1.0,0.31293817718291905,0.687061822817081,650,0.23836838750796685,0.34735500318674317,0.41427660930529
1964,37147,1924,1038,818,479,886,1924,1.0,0.5395010395010394,0.4604989604989605,627,0.42515592515592515,0.24896049896049896,0.32588357588357586
1965,37147,1053,333,269,339,720,1053,1.0,0.3162393162393162,0.6837606837606838,445,0.25546058879392214,0.32193732193732194,0.4226020892687559
1966,37147,2237,934,822,687,1303,2237,1.0,0.4175234689316048,0.5824765310683951,728,0.3674564148413053,0.30710773357174787,0.3254358515869468
1967,37147,6035,1933,1430,1282,4102,6035,1.0,0.3202982601491301,0.6797017398508699,3323,0.23695111847555925,0.21242750621375311,0.5506213753106877
1968,37147,2520,737,964,655,1783,2520,1.0,0.2924603174603175,0.7075396825396826,901,0.3825396825396825,0.25992063492063494,0.35753968253968255
1969,37147,3758,588,853,1750,3170,3758,1.0,0.15646620542841938,0.8435337945715806,1155,0.22698243746673763,0.4656732304417243,0.30734433209153805
1970,37147,4644,1745,1921,1459,2899,4644,1.0,0.3757536606373816,0.6242463393626184,1264,0.4136520241171404,0.31416881998277346,0.2721791559000861
1971,37147,2861,259,622,504,2602,2861,1.0,0.09052778748689269,0.9094722125131073,1735,0.21740650122334848,0.17616218105557496,0.6064313177210765
1972,37147,5822,1277,1527,1007,4545,5822,1.0,0.21934043284094812,0.7806595671590518,3288,0.26228100309172103,0.17296461697011337,0.5647543799381656
1973,37147,2978,456,751,1083,2522,2978,1.0,0.15312290127602418,0.8468770987239759,1144,0.25218267293485563,0.3636668905305574,0.38415043653458697
1974,37149,2695,53,595,1124,2642,2695,1.0,0.019666048237476808,0.9803339517625231,976,0.22077922077922077,0.41706864564007423,0.362152133580705
1975,37149,1704,20,205,657,1684,1704,1.0,0.011737089201877934,0.9882629107981221,842,0.12030516431924883,0.3855633802816901,0.49413145539906106
1976,37149,2814,250,651,1127,2564,2814,1.0,0.08884150675195451,0.9111584932480455,1036,0.23134328358208955,0.40049751243781095,0.3681592039800995
1977,37149,2562,26,620,993,2536,2562,1.0,0.01014832162373146,0.9898516783762685,949,0.2419984387197502,0.3875878220140515,0.3704137392661983
1978,37149,3217,258,1134,986,2959,3217,1.0,0.08019894311470314,0.9198010568852969,1097,0.35250233136462544,0.3064967360895244,0.3410009325458502
1979,37149,1616,19,370,627,1597,1616,1.0,0.011757425742574257,0.9882425742574258,619,0.22896039603960397,0.3879950495049505,0.38304455445544555
1980,37149,1964,77,438,722,1887,1964,1.0,0.03920570264765784,0.9607942973523421,804,0.2230142566191446,0.36761710794297353,0.4093686354378819
1981,37151,1102,108,137,584,994,1102,1.0,0.09800362976406533,0.9019963702359347,381,0.12431941923774954,0.52994555353902,0.3457350272232305
1982,37151,1797,66,224,847,1731,1797,1.0,0.03672787979966611,0.9632721202003339,726,0.1246521981079577,0.4713411240957151,0.4040066777963272
1983,37151,4404,187,537,1870,4217,4404,1.0,0.042461398728428704,0.9575386012715713,1997,0.12193460490463215,0.424613987284287,0.45345140781108084
1984,37151,2581,201,529,831,2380,2581,1.0,0.0778767919411081,0.9221232080588919,1221,0.2049593180937621,0.3219682293684618,0.4730724525377761
1985,37151,2956,899,949,560,2057,2956,1.0,0.30412719891745604,0.695872801082544,1447,0.321041948579161,0.18944519621109607,0.4895128552097429
1986,37151,2565,258,412,504,2307,2565,1.0,0.10058479532163743,0.8994152046783626,1649,0.16062378167641325,0.19649122807017544,0.6428849902534113
1987,37151,928,9,115,445,919,928,1.0,0.009698275862068966,0.990301724137931,368,0.12392241379310345,0.4795258620689655,0.39655172413793105
1988,37151,2750,176,318,1029,2574,2750,1.0,0.064,0.936,1403,0.11563636363636363,0.37418181818181817,0.5101818181818182
1989,37151,2319,186,603,855,2133,2319,1.0,0.08020698576972833,0.9197930142302717,861,0.26002587322121606,0.36869340232858994,0.37128072445019406
1990,37151,3012,180,414,1085,2832,3012,1.0,0.05976095617529881,0.9402390438247012,1513,0.13745019920318724,0.3602257636122178,0.502324037184595
1991,37151,2880,127,377,1274,2753,2880,1.0,0.044097222222222225,0.9559027777777778,1229,0.13090277777777778,0.4423611111111111,0.4267361111111111
1992,37151,2145,16,247,865,2129,2145,1.0,0.007459207459207459,0.9925407925407925,1033,0.11515151515151516,0.40326340326340326,0.48158508158508156
1993,37151,1960,12,210,982,1948,1960,1.0,0.006122448979591836,0.9938775510204082,768,0.10714285714285714,0.5010204081632653,0.39183673469387753
1994,37151,2443,42,332,1486,2401,2443,1.0,0.017191977077363897,0.9828080229226361,625,0.13589848546868605,0.6082685223086369,0.255832992222677
1995,37151,3445,285,470,804,3160,3445,1.0,0.08272859216255443,0.9172714078374455,2171,0.13642960812772134,0.23338171262699564,0.630188679245283
1996,37151,2437,164,320,1212,2273,2437,1.0,0.0672958555601149,0.9327041444398851,905,0.13130898645876077,0.49733278621255644,0.3713582273286828
1997,37151,1806,146,283,636,1660,1806,1.0,0.08084163898117387,0.9191583610188261,887,0.1566998892580288,0.3521594684385382,0.491140642303433
1998,37151,4274,121,600,1767,4153,4274,1.0,0.028310715956948992,0.971689284043051,1907,0.14038371548900327,0.41343004211511464,0.44618624239588206
1999,37151,2393,147,257,655,2246,2393,1.0,0.06142916840785625,0.9385708315921437,1481,0.10739657333890514,0.2737150020894275,0.6188884245716674
2000,37151,2439,247,318,899,2192,2439,1.0,0.1012710127101271,0.8987289872898729,1222,0.13038130381303814,0.36859368593685937,0.5010250102501025
2001,37151,2179,68,210,1042,2111,2179,1.0,0.031206975676916018,0.968793024323084,927,0.09637448370812299,0.4782010096374484,0.42542450665442866
2002,37151,3409,490,648,1162,2919,3409,1.0,0.1437371663244353,0.8562628336755647,1599,0.1900850689351716,0.3408624229979466,0.46905250806688176
2003,37151,3384,31,274,1446,3353,3384,1.0,0.009160756501182032,0.9908392434988179,1664,0.08096926713947991,0.42730496453900707,0.491725768321513
2004,37151,2938,28,300,1273,2910,2938,1.0,0.009530292716133424,0.9904697072838666,1365,0.10211027910142954,0.433287950987066,0.4646017699115044
2005,37151,3366,35,325,1651,3331,3366,1.0,0.010398098633392751,0.9896019013666072,1390,0.09655377302436126,0.4904931669637552,0.41295306001188353
2006,37151,3703,63,381,1854,3640,3703,1.0,0.017013232514177693,0.9829867674858223,1468,0.10288954901431271,0.5006751282743721,0.39643532271131515
2007,37151,1505,97,356,947,1408,1505,1.0,0.06445182724252492,0.935548172757475,202,0.23654485049833887,0.6292358803986711,0.13421926910299004
2008,37151,2563,69,302,1232,2494,2563,1.0,0.026921576277799453,0.9730784237222005,1029,0.11783066718689036,0.48068669527896996,0.40148263753413965
2009,37151,2193,185,301,1042,2008,2193,1.0,0.084359325125399,0.915640674874601,850,0.13725490196078433,0.4751481988144095,0.3875968992248062
2010,37151,4122,197,532,1875,3925,4122,1.0,0.04779233381853469,0.9522076661814654,1715,0.12906356137797187,0.45487627365356625,0.41606016496846193
2011,37151,3334,83,438,1396,3251,3334,1.0,0.02489502099580084,0.9751049790041991,1500,0.131373725254949,0.41871625674865026,0.44991001799640074
2012,37151,457,4,39,244,453,457,1.0,0.0087527352297593,0.9912472647702407,174,0.08533916849015317,0.5339168490153173,0.38074398249452956
2013,37151,2633,41,275,1090,2592,2633,1.0,0.015571591340676035,0.984428408659324,1268,0.10444360045575389,0.4139764527155336,0.48157994682871247
2014,37151,2254,96,407,1202,2158,2254,1.0,0.04259094942324756,0.9574090505767524,645,0.1805678793256433,0.5332741792369121,0.28615794143744455
2015,37151,2561,109,303,1058,2452,2561,1.0,0.04256149941429129,0.9574385005857087,1200,0.11831315892229598,0.41311987504880904,0.46856696602889497
2016,37151,3224,519,714,1099,2705,3224,1.0,0.1609801488833747,0.8390198511166254,1411,0.22146401985111663,0.3408808933002481,0.43765508684863524
2017,37151,3431,44,391,1755,3387,3431,1.0,0.012824249489944622,0.9871757505100553,1285,0.11396094433109881,0.5115126785193821,0.3745263771495191
2018,37151,2546,53,254,1273,2493,2546,1.0,0.020816967792615867,0.9791830322073841,1019,0.0997643362136685,0.5,0.4002356637863315
2019,37151,4333,59,376,2180,4274,4333,1.0,0.013616432033233325,0.9863835679667666,1777,0.08677590583891069,0.5031156242787906,0.41010846988229865
2020,37151,2267,79,267,1092,2188,2267,1.0,0.03484781649757389,0.9651521835024262,908,0.11777679752977503,0.48169386854874285,0.40052933392148216
2021,37153,868,154,146,191,714,868,1.0,0.1774193548387097,0.8225806451612904,531,0.16820276497695852,0.22004608294930875,0.6117511520737328
2022,37153,5936,1367,1583,1708,4569,5936,1.0,0.23028975741239893,0.7697102425876011,2645,0.26667789757412397,0.28773584905660377,0.4455862533692722
2023,37153,164,91,81,32,73,164,1.0,0.5548780487804879,0.4451219512195122,51,0.49390243902439024,0.1951219512195122,0.31097560975609756
2024,37153,2321,586,605,459,1735,2321,1.0,0.25247738043946577,0.7475226195605342,1257,0.26066350710900477,0.1977595863851788,0.5415769065058165
2025,37153,5985,2396,2129,991,3589,5985,1.0,0.4003341687552214,0.5996658312447786,2865,0.3557226399331663,0.16558061821219716,0.47869674185463656
2026,37153,4411,1934,1650,922,2477,4411,1.0,0.43844933121741103,0.561550668782589,1839,0.3740648379052369,0.20902289730219906,0.41691226479256405
2027,37153,392,5,44,169,387,392,1.0,0.012755102040816327,0.9872448979591837,179,0.11224489795918367,0.43112244897959184,0.45663265306122447
2028,37153,5470,936,1295,2026,4534,5470,1.0,0.17111517367458867,0.8288848263254114,2149,0.236745886654479,0.3703839122486289,0.39287020109689214
2029,37153,935,245,236,314,690,935,1.0,0.2620320855614973,0.7379679144385026,385,0.25240641711229944,0.3358288770053476,0.4117647058823529
2030,37153,220,34,40,89,186,220,1.0,0.15454545454545454,0.8454545454545455,91,0.18181818181818182,0.40454545454545454,0.41363636363636364
2031,37153,1974,570,532,575,1404,1974,1.0,0.2887537993920973,0.7112462006079028,867,0.2695035460992908,0.29128672745694023,0.439209726443769
2032,37153,1069,315,345,440,754,1069,1.0,0.29466791393826003,0.7053320860617399,284,0.32273152478952294,0.411599625818522,0.2656688493919551
2033,37153,1877,917,385,176,960,1877,1.0,0.4885455514118274,0.5114544485881726,1316,0.20511454448588173,0.09376664890783165,0.7011188066062867
2034,37153,1081,364,345,251,717,1081,1.0,0.3367252543940796,0.6632747456059205,485,0.3191489361702128,0.23219241443108232,0.4486586493987049
2035,37153,1591,175,285,596,1416,1591,1.0,0.10999371464487744,0.8900062853551226,710,0.1791326209930861,0.37460716530483973,0.4462602137020742
2036,37153,965,162,203,393,803,965,1.0,0.16787564766839377,0.8321243523316062,369,0.21036269430051813,0.4072538860103627,0.38238341968911915
2037,37155,1890,899,840,255,991,1890,1.0,0.4756613756613757,0.5243386243386243,795,0.4444444444444444,0.1349206349206349,0.42063492063492064
2038,37155,1103,328,372,125,775,1103,1.0,0.2973708068902992,0.7026291931097008,606,0.3372620126926564,0.11332728921124206,0.5494106980961015
2039,37155,3955,1681,1538,356,2274,3955,1.0,0.425031605562579,0.574968394437421,2061,0.3888748419721871,0.09001264222503161,0.5211125158027813
2040,37155,3136,1326,1139,611,1810,3136,1.0,0.42283163265306123,0.5771683673469388,1386,0.3632015306122449,0.19483418367346939,0.4419642857142857
2041,37155,638,92,141,118,546,638,1.0,0.14420062695924765,0.8557993730407524,379,0.22100313479623823,0.18495297805642633,0.5940438871473355
2042,37155,828,348,219,149,480,828,1.0,0.42028985507246375,0.5797101449275363,460,0.2644927536231884,0.17995169082125603,0.5555555555555556
2043,37155,754,78,70,301,676,754,1.0,0.10344827586206896,0.896551724137931,383,0.09283819628647215,0.39920424403183025,0.5079575596816976
2044,37155,5757,586,1265,2339,5171,5757,1.0,0.10178912628104916,0.8982108737189508,2153,0.21973249956574606,0.4062879972207747,0.3739795032134792
2045,37155,1574,1003,770,75,571,1574,1.0,0.6372299872935197,0.3627700127064803,729,0.4891994917407878,0.04764930114358323,0.46315120711562896
2046,37155,1366,433,376,354,933,1366,1.0,0.3169838945827233,0.6830161054172768,636,0.2752562225475842,0.2591508052708638,0.465592972181552
2047,37155,1544,570,459,269,974,1544,1.0,0.36917098445595853,0.6308290155440415,816,0.297279792746114,0.17422279792746115,0.5284974093264249
2048,37155,2989,941,763,621,2048,2989,1.0,0.3148210103713617,0.6851789896286383,1605,0.25526932084309134,0.20776179324188693,0.5369688859150218
2049,37155,4313,1368,926,302,2945,4313,1.0,0.31718061674008813,0.6828193832599119,3085,0.21469974495710642,0.07002086714583816,0.7152793878970554
2050,37155,3225,1315,1189,274,1910,3225,1.0,0.4077519379844961,0.5922480620155038,1762,0.36868217054263563,0.08496124031007751,0.5463565891472868
2051,37155,2749,25,524,486,2724,2749,1.0,0.009094216078574026,0.9909057839214259,1739,0.1906147690069116,0.17679156056747908,0.6325936704256093
2052,37155,4523,706,667,1161,3817,4523,1.0,0.15609108998452353,0.8439089100154764,2695,0.147468494362149,0.2566880389122264,0.5958434667256246
2053,37155,2175,417,513,292,1758,2175,1.0,0.1917241379310345,0.8082758620689655,1370,0.23586206896551723,0.13425287356321838,0.6298850574712643
2054,37155,2757,589,564,567,2168,2757,1.0,0.2136380123322452,0.7863619876677548,1626,0.2045701849836779,0.20565832426550598,0.5897714907508161
2055,37155,3843,265,645,473,3578,3843,1.0,0.06895654436638043,0.9310434556336196,2725,0.1678376268540203,0.12308092635961489,0.7090814467863649
2056,37155,2509,458,372,693,2051,2509,1.0,0.18254284575528099,0.817457154244719,1444,0.14826624153049023,0.27620565962534877,0.575528098844161
2057,37155,1561,180,306,216,1381,1561,1.0,0.11531069827033953,0.8846893017296604,1039,0.1960281870595772,0.13837283792440744,0.6655989750160154
2058,37155,1815,423,392,267,1392,1815,1.0,0.23305785123966943,0.7669421487603306,1156,0.2159779614325069,0.14710743801652892,0.6369146005509642
2059,37155,978,134,175,100,844,978,1.0,0.13701431492842536,0.8629856850715747,703,0.17893660531697342,0.10224948875255624,0.7188139059304703
2060,37155,3783,1100,943,757,2683,3783,1.0,0.2907745175786413,0.7092254824213587,2083,0.2492730637060534,0.20010573618821043,0.5506212001057362
2061,37155,2030,215,319,235,1815,2030,1.0,0.10591133004926108,0.8940886699507389,1476,0.15714285714285714,0.11576354679802955,0.7270935960591133
2062,37155,5244,1211,1301,594,4033,5244,1.0,0.23093058733791,0.7690694126620901,3349,0.248093058733791,0.11327231121281464,0.6386346300533944
2063,37155,1156,394,356,281,762,1156,1.0,0.3408304498269896,0.6591695501730104,519,0.3079584775086505,0.2430795847750865,0.44896193771626297
2064,37155,1666,212,326,220,1454,1666,1.0,0.12725090036014405,0.8727490996398559,1120,0.19567827130852342,0.13205282112845138,0.6722689075630253
2065,37155,2795,424,516,327,2371,2795,1.0,0.1516994633273703,0.8483005366726297,1952,0.18461538461538463,0.11699463327370305,0.6983899821109123
2066,37155,2732,111,562,482,2621,2732,1.0,0.04062957540263543,0.9593704245973645,1688,0.20571010248901903,0.17642752562225475,0.6178623718887262
2067,37155,4968,281,1055,758,4687,4968,1.0,0.056561996779388085,0.9434380032206119,3155,0.21235909822866345,0.15257648953301128,0.6350644122383253
2068,37155,1466,1268,1091,25,198,1466,1.0,0.8649386084583902,0.13506139154160982,350,0.7442019099590723,0.017053206002728513,0.23874488403819918
2069,37155,726,228,288,80,498,726,1.0,0.3140495867768595,0.6859504132231405,358,0.39669421487603307,0.11019283746556474,0.4931129476584022
2070,37155,2148,587,579,517,1561,2148,1.0,0.2732774674115456,0.7267225325884544,1052,0.26955307262569833,0.24068901303538176,0.4897579143389199
2071,37155,2738,925,940,406,1813,2738,1.0,0.33783783783783783,0.6621621621621622,1392,0.34331628926223523,0.14828341855368882,0.508400292184076
2072,37155,1995,580,462,301,1415,1995,1.0,0.2907268170426065,0.7092731829573935,1232,0.23157894736842105,0.15087719298245614,0.6175438596491228
2073,37155,1842,241,315,687,1601,1842,1.0,0.13083604777415853,0.8691639522258415,840,0.17100977198697068,0.3729641693811075,0.4560260586319218
2074,37155,1022,514,496,95,508,1022,1.0,0.50293542074364,0.49706457925636005,431,0.48532289628180036,0.09295499021526418,0.4217221135029354
2075,37155,2032,298,452,697,1734,2032,1.0,0.1466535433070866,0.8533464566929134,883,0.22244094488188976,0.34301181102362205,0.4345472440944882
2076,37155,1706,490,425,353,1216,1706,1.0,0.28722157092614303,0.712778429073857,928,0.24912075029308323,0.20691676436107856,0.5439624853458382
2077,37155,2210,216,337,291,1994,2210,1.0,0.09773755656108597,0.902262443438914,1582,0.15248868778280544,0.13167420814479638,0.7158371040723982
2078,37157,5627,2368,1939,1019,3259,5627,1.0,0.4208281499911143,0.5791718500088857,2669,0.3445885907232984,0.18109116758485871,0.4743202416918429
2079,37157,4931,1219,1429,1721,3712,4931,1.0,0.24721151896167107,0.752788481038329,1781,0.28979922936524033,0.3490164266882985,0.36118434394646115
2080,37157,3442,879,879,995,2563,3442,1.0,0.25537478210342823,0.7446252178965718,1568,0.25537478210342823,0.28907611853573506,0.4555490993608367
2081,37157,5139,956,1102,1624,4183,5139,1.0,0.1860284101965363,0.8139715898034637,2413,0.21443860673282739,0.31601478886942985,0.46954660439774276
2082,37157,5383,794,1114,2299,4589,5383,1.0,0.1475013932751254,0.8524986067248747,1970,0.20694779862530188,0.42708526843767414,0.365966932937024
2083,37157,4457,662,857,1711,3795,4457,1.0,0.1485304016154364,0.8514695983845636,1889,0.1922818039039713,0.3838905093111959,0.42382768678483285
2084,37157,5454,939,1075,1571,4515,5454,1.0,0.17216721672167218,0.8278327832783279,2808,0.1971030436376971,0.28804547121378804,0.5148514851485149
2085,37157,3827,802,972,1482,3025,3827,1.0,0.20956362686177163,0.7904363731382283,1373,0.25398484452573816,0.38724849751763785,0.358766657956624
2086,37157,2914,611,634,830,2303,2914,1.0,0.20967741935483872,0.7903225806451613,1450,0.2175703500343171,0.2848318462594372,0.49759780370624573
2087,37157,4362,1453,1321,1320,2909,4362,1.0,0.33310408069692804,0.666895919303072,1721,0.302842732691426,0.30261348005502064,0.39454378725355344
2088,37157,4601,195,664,1891,4406,4601,1.0,0.04238209084981526,0.9576179091501847,2046,0.14431645294501194,0.41099760921538797,0.4446859378396001
2089,37157,2114,251,389,868,1863,2114,1.0,0.11873226111636707,0.881267738883633,857,0.18401135288552506,0.4105960264900662,0.40539262062440873
2090,37157,2870,661,824,823,2209,2870,1.0,0.23031358885017422,0.7696864111498258,1223,0.28710801393728225,0.2867595818815331,0.42613240418118464
2091,37157,1522,390,390,484,1132,1522,1.0,0.25624178712220763,0.7437582128777924,648,0.25624178712220763,0.3180026281208936,0.42575558475689884
2092,37157,2675,180,454,1268,2495,2675,1.0,0.06728971962616823,0.9327102803738317,953,0.1697196261682243,0.47401869158878507,0.35626168224299065
2093,37157,4835,599,929,1697,4236,4835,1.0,0.12388831437435367,0.8761116856256463,2209,0.1921406411582213,0.3509824198552223,0.45687693898655635
2094,37157,3613,108,545,1742,3505,3613,1.0,0.02989205646277332,0.9701079435372267,1326,0.15084417381677276,0.48214779961251036,0.36700802657071685
2095,37157,5088,416,834,1882,4672,5088,1.0,0.08176100628930817,0.9182389937106918,2372,0.16391509433962265,0.36988993710691825,0.4661949685534591
2096,37159,2705,335,423,694,2370,2705,1.0,0.12384473197781885,0.8761552680221811,1588,0.15637707948243992,0.2565619223659889,0.5870609981515712
2097,37159,1640,84,212,683,1556,1640,1.0,0.05121951219512195,0.948780487804878,745,0.12926829268292683,0.4164634146341463,0.45426829268292684
2098,37159,3106,58,327,1257,3048,3106,1.0,0.018673535093367676,0.9813264649066323,1522,0.10528010302640052,0.4047005795235029,0.4900193174500966
2099,37159,2399,43,250,1096,2356,2399,1.0,0.01792413505627345,0.9820758649437266,1053,0.10421008753647353,0.45685702375989995,0.4389328887036265
2100,37159,1265,412,474,433,853,1265,1.0,0.3256916996047431,0.6743083003952569,358,0.37470355731225297,0.3422924901185771,0.28300395256916994
2101,37159,2577,53,299,1337,2524,2577,1.0,0.020566550252231277,0.9794334497477687,941,0.11602638727202173,0.5188203337213815,0.36515327900659683
2102,37159,2347,52,246,1036,2295,2347,1.0,0.022155943757988922,0.9778440562420111,1065,0.1048146570089476,0.4414145717937793,0.4537707711972731
2103,37159,1952,202,428,922,1750,1952,1.0,0.10348360655737705,0.8965163934426229,602,0.2192622950819672,0.4723360655737705,0.3084016393442623
2104,37159,2709,97,407,1232,2612,2709,1.0,0.03580657069029162,0.9641934293097084,1070,0.15023994093761536,0.45478036175710596,0.3949796973052787
2105,37159,2065,430,538,737,1635,2065,1.0,0.20823244552058112,0.7917675544794189,790,0.2605326876513317,0.35690072639225184,0.38256658595641646
2106,37159,3018,895,1015,806,2123,3018,1.0,0.29655400927766734,0.7034459907223327,1197,0.33631544068919816,0.267064280980782,0.3966202783300199
2107,37159,1638,249,332,757,1389,1638,1.0,0.152014652014652,0.847985347985348,549,0.2026862026862027,0.4621489621489622,0.33516483516483514
2108,37159,3910,35,459,1809,3875,3910,1.0,0.008951406649616368,0.9910485933503836,1642,0.11739130434782609,0.46265984654731457,0.41994884910485936
2109,37159,1353,175,285,606,1178,1353,1.0,0.1293422025129342,0.8706577974870657,462,0.2106430155210643,0.44789356984478934,0.34146341463414637
2110,37159,2576,279,665,1276,2297,2576,1.0,0.10830745341614907,0.8916925465838509,635,0.25815217391304346,0.4953416149068323,0.24650621118012422
2111,37159,2598,68,384,1388,2530,2598,1.0,0.02617397998460354,0.9738260200153964,826,0.14780600461893764,0.5342571208622017,0.31793687451886066
2112,37159,1777,15,171,997,1762,1777,1.0,0.008441193021947102,0.9915588069780529,609,0.09622960045019696,0.5610579628587508,0.34271243669105234
2113,37159,3150,291,508,871,2859,3150,1.0,0.09238095238095238,0.9076190476190477,1771,0.16126984126984126,0.2765079365079365,0.5622222222222222
2114,37159,2773,308,671,1148,2465,2773,1.0,0.11107104219257122,0.8889289578074288,954,0.2419761990623873,0.4139920663541291,0.3440317345834836
2115,37159,1644,445,420,439,1199,1644,1.0,0.2706812652068126,0.7293187347931873,785,0.25547445255474455,0.2670316301703163,0.4774939172749392
2116,37159,1290,79,217,665,1211,1290,1.0,0.06124031007751938,0.9387596899224806,408,0.1682170542635659,0.5155038759689923,0.31627906976744186
2117,37159,4371,770,524,806,3601,4371,1.0,0.17616106154198125,0.8238389384580188,3041,0.11988103408830932,0.18439716312056736,0.6957218027911233
2118,37159,4115,80,481,2098,4035,4115,1.0,0.019441069258809233,0.9805589307411907,1536,0.11688942891859053,0.5098420413122722,0.3732685297691373
2119,37159,1308,95,210,628,1213,1308,1.0,0.07262996941896024,0.9273700305810397,470,0.16055045871559634,0.4801223241590214,0.35932721712538224
2120,37159,3415,831,993,707,2584,3415,1.0,0.24333821376281112,0.7566617862371888,1715,0.29077598828696927,0.20702781844802343,0.5021961932650073
2121,37159,3717,292,750,1490,3425,3717,1.0,0.07855797686306161,0.9214420231369383,1477,0.20177562550443906,0.4008609093354856,0.3973634651600753
2122,37159,1668,109,295,730,1559,1668,1.0,0.06534772182254196,0.934652278177458,643,0.17685851318944845,0.43764988009592326,0.3854916067146283
2123,37159,3403,248,544,1571,3155,3403,1.0,0.07287687334704672,0.9271231266529533,1288,0.15985894798707023,0.4616514839847194,0.3784895680282104
2124,37159,1771,12,208,792,1759,1771,1.0,0.006775832862789385,0.9932241671372106,771,0.11744776962168267,0.4472049689440994,0.435347261434218
2125,37159,2834,216,427,1336,2618,2834,1.0,0.07621736062103035,0.9237826393789696,1071,0.15067043048694426,0.47141848976711365,0.3779110797459421
2126,37159,2775,110,364,1163,2665,2775,1.0,0.03963963963963964,0.9603603603603603,1248,0.13117117117117116,0.4190990990990991,0.44972972972972974
2127,37159,3139,1227,1232,568,1912,3139,1.0,0.3908888180949347,0.6091111819050653,1339,0.3924816820643517,0.18094934692577255,0.42656897100987573
2128,37159,1194,968,688,30,226,1194,1.0,0.8107202680067002,0.18927973199329984,476,0.576214405360134,0.02512562814070352,0.39865996649916247
2129,37159,1831,18,237,956,1813,1831,1.0,0.009830693610049153,0.9901693063899508,638,0.1294374658656472,0.5221190606226106,0.3484434735117422
2130,37159,891,4,119,451,887,891,1.0,0.004489337822671156,0.9955106621773289,321,0.1335578002244669,0.5061728395061729,0.3602693602693603
2131,37159,2123,29,218,968,2094,2123,1.0,0.013659915214319359,0.9863400847856807,937,0.10268487988695242,0.45595854922279794,0.44135657089024966
2132,37159,3300,1507,1384,583,1793,3300,1.0,0.45666666666666667,0.5433333333333333,1333,0.4193939393939394,0.17666666666666667,0.40393939393939393
2133,37159,2001,1782,1203,11,219,2001,1.0,0.8905547226386806,0.10944527736131934,787,0.6011994002998501,0.005497251374312844,0.3933033483258371
2134,37159,1972,215,352,774,1757,1972,1.0,0.10902636916835699,0.890973630831643,846,0.17849898580121704,0.3924949290060852,0.4290060851926978
2135,37159,2596,497,632,675,2099,2596,1.0,0.19144838212634824,0.8085516178736518,1289,0.24345146379044685,0.2600154083204931,0.49653312788906007
2136,37159,1781,473,606,590,1308,1781,1.0,0.26558113419427287,0.7344188658057271,585,0.34025828186412127,0.3312745648512072,0.3284671532846715
2137,37159,2596,791,890,583,1805,2596,1.0,0.3046995377503852,0.6953004622496148,1123,0.3428351309707242,0.2245762711864407,0.43258859784283515
2138,37159,1438,521,543,253,917,1438,1.0,0.3623087621696801,0.6376912378303199,642,0.3776077885952712,0.17593880389429764,0.44645340751043117
2139,37159,2755,809,1019,823,1946,2755,1.0,0.29364791288566244,0.7063520871143376,913,0.36987295825771327,0.2987295825771325,0.3313974591651543
2140,37161,2715,209,404,997,2506,2715,1.0,0.07697974217311233,0.9230202578268877,1314,0.14880294659300183,0.36721915285451195,0.4839779005524862
2141,37161,2809,75,415,1210,2734,2809,1.0,0.026699893200427198,0.9733001067995728,1184,0.14773940904236382,0.4307582769668921,0.42150231399074406
2142,37161,3988,398,841,1544,3590,3988,1.0,0.09979939819458375,0.9002006018054163,1603,0.2108826479438315,0.38716148445336007,0.40195586760280844
2143,37161,2079,265,357,658,1814,2079,1.0,0.12746512746512748,0.8725348725348725,1064,0.1717171717171717,0.3164983164983165,0.5117845117845118
2144,37161,2298,170,579,929,2128,2298,1.0,0.07397737162750218,0.9260226283724978,790,0.2519582245430809,0.4042645778938207,0.3437771975630983
2145,37161,4868,1147,1360,1312,3721,4868,1.0,0.235620377978636,0.764379622021364,2196,0.27937551355792933,0.2695152013147083,0.45110928512736237
2146,37161,4236,1017,1089,1104,3219,4236,1.0,0.24008498583569404,0.759915014164306,2043,0.25708215297450426,0.26062322946175637,0.48229461756373937
2147,37161,3068,465,688,900,2603,3068,1.0,0.1515645371577575,0.8484354628422425,1480,0.2242503259452412,0.29335071707953064,0.48239895697522817
2148,37161,1275,4,145,604,1271,1275,1.0,0.003137254901960784,0.9968627450980392,526,0.11372549019607843,0.47372549019607846,0.4125490196078431
2149,37161,2261,88,236,1131,2173,2261,1.0,0.038920831490490936,0.961079168509509,894,0.10437859354268023,0.5002211410880142,0.3954002653693056
2150,37161,2401,202,355,847,2199,2401,1.0,0.08413161182840483,0.9158683881715952,1199,0.14785506039150353,0.35276967930029157,0.4993752603082049
2151,37161,1438,14,189,726,1424,1438,1.0,0.009735744089012517,0.9902642559109874,523,0.13143254520166897,0.5048678720445062,0.36369958275382475
2152,37161,3990,100,477,1659,3890,3990,1.0,0.02506265664160401,0.974937343358396,1854,0.11954887218045113,0.41578947368421054,0.46466165413533833
2153,37161,2225,167,449,895,2058,2225,1.0,0.0750561797752809,0.9249438202247191,881,0.20179775280898876,0.40224719101123596,0.3959550561797753
2154,37161,3934,268,480,1122,3666,3934,1.0,0.0681240467717336,0.9318759532282664,2332,0.12201321809862735,0.2852058973055414,0.5927808845958312
2155,37161,6578,258,881,2499,6320,6578,1.0,0.03922164791730009,0.9607783520826999,3198,0.13393128610519914,0.3799027059896625,0.48616600790513836
2156,37161,2423,280,429,817,2143,2423,1.0,0.11555922410235246,0.8844407758976476,1177,0.17705323978539,0.3371853074700784,0.4857614527445316
2157,37163,3034,1606,1477,625,1428,3034,1.0,0.5293342122610415,0.47066578773895845,932,0.48681608437706,0.2059986816084377,0.3071852340145023
2158,37163,1998,168,275,800,1830,1998,1.0,0.08408408408408409,0.9159159159159159,923,0.13763763763763764,0.4004004004004004,0.461961961961962
2159,37163,1987,250,302,591,1737,1987,1.0,0.12581781580271767,0.8741821841972823,1094,0.15198792148968293,0.29743331655762456,0.5505787619526925
2160,37163,1625,588,466,376,1037,1625,1.0,0.3618461538461539,0.6381538461538462,783,0.2867692307692308,0.23138461538461538,0.48184615384615387
2161,37163,1126,167,210,454,959,1126,1.0,0.1483126110124334,0.8516873889875666,462,0.18650088809946713,0.40319715808170514,0.4103019538188277
2162,37163,1921,185,263,720,1736,1921,1.0,0.09630400832899531,0.9036959916710047,938,0.1369078604893285,0.3748047891723061,0.48828735033836546
2163,37163,3233,1548,1317,575,1685,3233,1.0,0.4788122486854315,0.5211877513145685,1341,0.4073615836684194,0.17785338694710795,0.41478502938447265
2164,37163,1491,617,532,351,874,1491,1.0,0.4138162307176392,0.5861837692823608,608,0.3568075117370892,0.23541247484909456,0.40778001341381626
2165,37163,1230,912,662,87,318,1230,1.0,0.7414634146341463,0.25853658536585367,481,0.5382113821138211,0.07073170731707316,0.3910569105691057
2166,37163,2083,487,566,719,1596,2083,1.0,0.23379740758521364,0.7662025924147864,798,0.271723475756121,0.3451752280364858,0.3831012962073932
2167,37163,2443,393,570,970,2050,2443,1.0,0.16086778550961933,0.8391322144903807,903,0.23331968890708146,0.39705280392959474,0.36962750716332377
2168,37163,3050,346,308,1358,2704,3050,1.0,0.11344262295081967,0.8865573770491804,1384,0.10098360655737705,0.44524590163934424,0.45377049180327866
2169,37163,2251,534,436,576,1717,2251,1.0,0.2372278987116837,0.7627721012883163,1239,0.19369169258107508,0.2558862727676588,0.5504220346512662
2170,37163,2708,774,442,856,1934,2708,1.0,0.2858197932053176,0.7141802067946824,1410,0.16322008862629248,0.31610044313146235,0.5206794682422452
2171,37163,1601,221,268,594,1380,1601,1.0,0.13803872579637727,0.8619612742036228,739,0.16739537788881947,0.37101811367895066,0.46158650843222987
2172,37163,2008,1139,941,365,869,2008,1.0,0.5672310756972112,0.43276892430278885,702,0.4686254980079681,0.18177290836653387,0.34960159362549803
2173,37163,1722,536,429,347,1186,1722,1.0,0.31126596980255516,0.6887340301974448,946,0.24912891986062718,0.20150987224157957,0.5493612078977933
2174,37163,2318,570,509,654,1748,2318,1.0,0.2459016393442623,0.7540983606557377,1155,0.21958584987057808,0.28213977566867987,0.498274374460742
2175,37163,1962,331,353,638,1631,1962,1.0,0.16870540265035677,0.8312945973496432,971,0.1799184505606524,0.3251783893985729,0.4949031600407747
2176,37163,1841,567,454,374,1274,1841,1.0,0.30798479087452474,0.6920152091254753,1013,0.24660510592069526,0.20315046170559478,0.5502444323737099
2177,37163,2875,486,425,1228,2389,2875,1.0,0.16904347826086957,0.8309565217391305,1222,0.14782608695652175,0.4271304347826087,0.4250434782608696
2178,37163,1824,242,276,665,1582,1824,1.0,0.13267543859649122,0.8673245614035088,883,0.1513157894736842,0.3645833333333333,0.48410087719298245
2179,37163,823,49,85,499,774,823,1.0,0.05953827460510328,0.9404617253948967,239,0.10328068043742406,0.606318347509113,0.29040097205346294
2180,37165,1627,356,325,446,1271,1627,1.0,0.21880762138905963,0.7811923786109404,856,0.1997541487400123,0.27412415488629377,0.5261216963736939
2181,37165,3372,986,987,1041,2386,3372,1.0,0.29240806642941874,0.7075919335705813,1344,0.29270462633451955,0.3087188612099644,0.398576512455516
2182,37165,4308,969,1180,1404,3339,4308,1.0,0.22493036211699163,0.7750696378830083,1724,0.27390900649953576,0.32590529247910865,0.40018570102135564
2183,37165,2393,476,500,597,1917,2393,1.0,0.19891349770162975,0.8010865022983702,1296,0.20894274968658588,0.24947764312578355,0.5415796071876305
2184,37165,3703,1734,1369,654,1969,3703,1.0,0.4682689711045099,0.5317310288954902,1680,0.36970024304617877,0.1766135565757494,0.45368620037807184
2185,37165,2671,774,645,544,1897,2671,1.0,0.28977910894795955,0.7102208910520404,1482,0.2414825907899663,0.20366903781355297,0.5548483713964807
2186,37165,2189,1329,1060,232,860,2189,1.0,0.6071265417999087,0.39287345820009134,897,0.4842393787117405,0.10598446779351302,0.40977615349474644
2187,37165,1755,261,297,541,1494,1755,1.0,0.14871794871794872,0.8512820512820513,917,0.16923076923076924,0.30826210826210826,0.5225071225071225
2188,37165,1780,852,217,134,928,1780,1.0,0.4786516853932584,0.5213483146067416,1429,0.12191011235955056,0.07528089887640449,0.8028089887640449
2189,37165,3286,2216,1635,238,1070,3286,1.0,0.6743761412051126,0.3256238587948874,1413,0.49756542909312235,0.07242848447961046,0.4300060864272672
2190,37167,1811,211,261,466,1600,1811,1.0,0.11651021535063501,0.883489784649365,1084,0.14411927112092768,0.25731639977912757,0.5985643290999448
2191,37167,3401,32,384,1639,3369,3401,1.0,0.009408997353719493,0.9905910026462805,1378,0.11290796824463394,0.48191708321082033,0.4051749485445457
2192,37167,2070,1413,1199,105,657,2070,1.0,0.6826086956521739,0.3173913043478261,766,0.5792270531400966,0.050724637681159424,0.370048309178744
2193,37167,2042,52,252,965,1990,2042,1.0,0.025465230166503428,0.9745347698334965,825,0.12340842311459353,0.47257590597453475,0.4040156709108717
2194,37167,2341,320,571,902,2021,2341,1.0,0.13669372063220847,0.8633062793677916,868,0.24391285775309696,0.3853054250320376,0.37078171721486547
2195,37167,3094,47,337,1550,3047,3094,1.0,0.015190691661279896,0.9848093083387202,1207,0.10892049127343245,0.5009696186166774,0.3901098901098901
2196,37167,1926,431,434,527,1495,1926,1.0,0.2237798546209761,0.7762201453790238,965,0.22533748701973,0.2736240913811007,0.5010384215991692
2197,37167,1236,40,143,517,1196,1236,1.0,0.032362459546925564,0.9676375404530745,576,0.1156957928802589,0.41828478964401294,0.46601941747572817
2198,37167,2217,727,401,501,1490,2217,1.0,0.32792061344158774,0.6720793865584123,1315,0.18087505638249887,0.2259810554803789,0.5931438881371223
2199,37167,1985,136,357,995,1849,1985,1.0,0.06851385390428212,0.9314861460957179,633,0.17984886649874054,0.5012594458438288,0.31889168765743076
2200,37167,1699,7,203,968,1692,1699,1.0,0.004120070629782225,0.9958799293702177,528,0.11948204826368453,0.5697469099470277,0.3107710417892878
2201,37167,1725,141,339,583,1584,1725,1.0,0.0817391304347826,0.9182608695652174,803,0.19652173913043477,0.33797101449275363,0.46550724637681157
2202,37167,1806,130,255,571,1676,1806,1.0,0.07198228128460686,0.9280177187153932,980,0.14119601328903655,0.31616832779623477,0.5426356589147286
2203,37167,2457,10,228,1370,2447,2457,1.0,0.00407000407000407,0.995929995929996,859,0.0927960927960928,0.5575905575905576,0.3496133496133496
2204,37167,2883,27,312,1680,2856,2883,1.0,0.009365244536940686,0.9906347554630593,891,0.10822060353798127,0.5827263267429761,0.3090530697190427
2205,37167,1177,24,182,580,1153,1177,1.0,0.020390824129141887,0.9796091758708582,415,0.1546304163126593,0.4927782497875956,0.3525913338997451
2206,37167,1875,87,290,818,1788,1875,1.0,0.0464,0.9536,767,0.15466666666666667,0.4362666666666667,0.4090666666666667
2207,37167,1357,5,133,833,1352,1357,1.0,0.0036845983787767134,0.9963154016212233,391,0.09801031687546058,0.6138540899042004,0.288135593220339
2208,37167,2623,256,534,1200,2367,2623,1.0,0.09759817003431186,0.9024018299656882,889,0.20358368280594738,0.4574914220358368,0.3389248951582158
2209,37167,2193,228,656,904,1965,2193,1.0,0.1039671682626539,0.896032831737346,633,0.29913360693114455,0.4122207022343821,0.28864569083447333
2210,37167,2017,188,350,935,1829,2017,1.0,0.0932077342588002,0.9067922657411998,732,0.17352503718393653,0.4635597421913733,0.3629152206246901
2211,37167,1549,76,247,688,1473,1549,1.0,0.04906391220142027,0.9509360877985797,614,0.1594577146546159,0.44415752098127825,0.39638476436410586
2212,37167,1368,303,360,572,1065,1368,1.0,0.22149122807017543,0.7785087719298246,436,0.2631578947368421,0.41812865497076024,0.31871345029239767
2213,37169,2147,15,287,967,2132,2147,1.0,0.0069864927806241265,0.9930135072193759,893,0.13367489520260828,0.4503959012575687,0.415929203539823
2214,37169,3341,41,597,1717,3300,3341,1.0,0.012271774917689314,0.9877282250823107,1027,0.17868901526489075,0.5139179886261598,0.30739299610894943
2215,37169,1602,8,170,721,1594,1602,1.0,0.004993757802746567,0.9950062421972534,711,0.10611735330836454,0.4500624219725343,0.4438202247191011
2216,37169,4513,76,582,1739,4437,4513,1.0,0.016840239308663858,0.9831597606913361,2192,0.1289607799689785,0.3853312652337691,0.4857079547972524
2217,37169,761,79,143,282,682,761,1.0,0.1038107752956636,0.8961892247043364,336,0.18791064388961892,0.37056504599211565,0.44152431011826543
2218,37169,1004,15,151,395,989,1004,1.0,0.014940239043824702,0.9850597609561753,458,0.150398406374502,0.3934262948207171,0.45617529880478086
2219,37169,2198,33,339,757,2165,2198,1.0,0.015013648771610554,0.9849863512283894,1102,0.15423111919927207,0.34440400363967244,0.5013648771610555
2220,37169,1984,24,253,942,1960,1984,1.0,0.012096774193548387,0.9879032258064516,789,0.1275201612903226,0.4747983870967742,0.39768145161290325
2221,37169,1446,27,200,616,1419,1446,1.0,0.01867219917012448,0.9813278008298755,630,0.13831258644536654,0.4260027662517289,0.43568464730290457
2222,37169,772,30,110,329,742,772,1.0,0.038860103626943004,0.961139896373057,333,0.14248704663212436,0.4261658031088083,0.43134715025906734
2223,37169,2459,84,397,944,2375,2459,1.0,0.03416022773485156,0.9658397722651484,1118,0.16144774298495324,0.38389589263928425,0.4546563643757625
2224,37169,2310,18,300,1057,2292,2310,1.0,0.007792207792207792,0.9922077922077922,953,0.12987012987012986,0.4575757575757576,0.41255411255411256
2225,37169,811,39,169,322,772,811,1.0,0.04808877928483354,0.9519112207151664,320,0.20838471023427868,0.3970406905055487,0.39457459926017263
2226,37169,1680,65,243,596,1615,1680,1.0,0.03869047619047619,0.9613095238095238,841,0.14464285714285716,0.3547619047619048,0.5005952380952381
2227,37169,2683,17,396,1157,2666,2683,1.0,0.00633619083115915,0.9936638091688409,1130,0.1475959746552367,0.43123369362653746,0.4211703317182259
2228,37169,1192,122,213,442,1070,1192,1.0,0.10234899328859061,0.8976510067114094,537,0.17869127516778524,0.37080536912751677,0.45050335570469796
2229,37169,543,273,234,108,270,543,1.0,0.5027624309392266,0.4972375690607735,201,0.430939226519337,0.19889502762430938,0.3701657458563536
2230,37169,2071,190,459,789,1881,2071,1.0,0.09174311926605505,0.908256880733945,823,0.22163206180589087,0.3809753742153549,0.3973925639787542
2231,37169,1870,377,535,630,1493,1870,1.0,0.2016042780748663,0.7983957219251336,705,0.28609625668449196,0.33689839572192515,0.3770053475935829
2232,37169,1493,12,235,714,1481,1493,1.0,0.008037508372404554,0.9919624916275954,544,0.15740120562625587,0.478231748158071,0.3643670462156731
2233,37171,1782,25,195,573,1757,1782,1.0,0.014029180695847363,0.9859708193041526,1014,0.10942760942760943,0.32154882154882153,0.569023569023569
2234,37171,2490,54,373,943,2436,2490,1.0,0.021686746987951807,0.9783132530120482,1174,0.1497991967871486,0.378714859437751,0.4714859437751004
2235,37171,2790,22,305,1182,2768,2790,1.0,0.007885304659498209,0.9921146953405018,1303,0.10931899641577061,0.4236559139784946,0.46702508960573474
2236,37171,1646,38,192,574,1608,1646,1.0,0.023086269744835967,0.976913730255164,880,0.1166464155528554,0.3487241798298906,0.534629404617254
2237,37171,3344,262,558,735,3082,3344,1.0,0.07834928229665072,0.9216507177033493,2051,0.16686602870813397,0.21979665071770335,0.6133373205741627
2238,37171,1967,92,252,678,1875,1967,1.0,0.04677173360447382,0.9532282663955262,1037,0.12811387900355872,0.34468734112862226,0.527198779867819
2239,37171,3071,39,430,978,3032,3071,1.0,0.012699446434386193,0.9873005535656139,1663,0.14001953760989905,0.3184630413546076,0.5415174210354933
2240,37171,1593,48,411,476,1545,1593,1.0,0.030131826741996232,0.9698681732580038,706,0.2580037664783427,0.2988072818581293,0.44318895166352795
2241,37171,1832,64,254,540,1768,1832,1.0,0.034934497816593885,0.9650655021834061,1038,0.13864628820960698,0.29475982532751094,0.5665938864628821
2242,37171,872,0,118,381,872,872,1.0,0.0,1.0,373,0.1353211009174312,0.4369266055045872,0.42775229357798167
2243,37171,1589,30,254,676,1559,1589,1.0,0.018879798615481436,0.9811202013845186,659,0.15984896161107615,0.4254247954688483,0.41472624292007554
2244,37171,1747,32,229,634,1715,1747,1.0,0.018317115054378934,0.9816828849456211,884,0.13108185460789926,0.36290784201488263,0.5060103033772181
2245,37171,2114,11,273,870,2103,2114,1.0,0.005203405865657522,0.9947965941343425,971,0.1291390728476821,0.41154210028382215,0.45931882686849573
2246,37171,1669,116,367,593,1553,1669,1.0,0.0695026962252846,0.9304973037747154,709,0.21989215098861595,0.35530257639304974,0.42480527261833434
2247,37171,3220,33,406,1152,3187,3220,1.0,0.010248447204968944,0.989751552795031,1662,0.12608695652173912,0.3577639751552795,0.5161490683229814
2248,37171,1510,121,339,453,1389,1510,1.0,0.08013245033112583,0.9198675496688742,718,0.22450331125827813,0.3,0.47549668874172185
2249,37171,2791,212,503,910,2579,2791,1.0,0.07595843783590112,0.9240415621640989,1378,0.1802221426012182,0.32604801146542456,0.4937298459333572
2250,37171,1421,26,253,492,1395,1421,1.0,0.018296973961998593,0.9817030260380014,676,0.17804363124560169,0.3462350457424349,0.4757213230119634
2251,37171,1121,76,236,418,1045,1121,1.0,0.06779661016949153,0.9322033898305084,467,0.21052631578947367,0.3728813559322034,0.41659232827832293
2252,37171,2535,208,400,658,2327,2535,1.0,0.08205128205128205,0.9179487179487179,1477,0.15779092702169625,0.25956607495069034,0.5826429980276134
2253,37171,2029,44,339,975,1985,2029,1.0,0.02168555938886151,0.9783144406111385,715,0.16707737801872843,0.48053228191227204,0.3523903400689995
2254,37171,1730,180,417,736,1550,1730,1.0,0.10404624277456648,0.8959537572254336,577,0.24104046242774566,0.4254335260115607,0.33352601156069367
2255,37171,1122,50,193,200,1072,1122,1.0,0.044563279857397504,0.9554367201426025,729,0.17201426024955438,0.17825311942959002,0.6497326203208557
2256,37171,1367,111,350,489,1256,1367,1.0,0.08119970738844184,0.9188002926115582,528,0.25603511338697876,0.35771762984637895,0.3862472567666423
2257,37171,2301,31,335,746,2270,2301,1.0,0.013472403302911778,0.9865275966970882,1220,0.14558887440243373,0.32420686657974795,0.5302042590178183
2258,37171,1793,48,299,825,1745,1793,1.0,0.026770775237032907,0.9732292247629671,669,0.16675962074735082,0.4601226993865031,0.37311767986614613
2259,37171,2458,30,439,823,2428,2458,1.0,0.012205044751830757,0.9877949552481693,1196,0.1786004882017901,0.33482506102522375,0.48657445077298617
2260,37171,1325,12,189,492,1313,1325,1.0,0.009056603773584906,0.9909433962264151,644,0.14264150943396225,0.3713207547169811,0.48603773584905663
2261,37171,1227,11,117,590,1216,1227,1.0,0.008964955175224124,0.9910350448247759,520,0.09535452322738386,0.4808475957620212,0.42379788101059496
2262,37173,3926,43,904,640,3883,3926,1.0,0.010952623535404993,0.9890473764645951,2382,0.23025980641874683,0.163015792154865,0.6067244014263882
2263,37173,2389,5,616,774,2384,2389,1.0,0.002092925910422771,0.9979070740895772,999,0.2578484721640854,0.32398493093344494,0.41816659690246966
2264,37173,2433,17,588,725,2416,2433,1.0,0.006987258528565557,0.9930127414714345,1120,0.24167694204685575,0.2979860254829429,0.4603370324702014
2265,37173,1204,2,304,517,1202,1204,1.0,0.0016611295681063123,0.9983388704318937,383,0.25249169435215946,0.42940199335548174,0.3181063122923588
2266,37173,760,0,206,320,760,760,1.0,0.0,1.0,234,0.2710526315789474,0.42105263157894735,0.3078947368421053
2267,37175,544,7,97,206,537,544,1.0,0.012867647058823529,0.9871323529411765,241,0.17830882352941177,0.3786764705882353,0.4430147058823529
2268,37175,2970,137,656,988,2833,2970,1.0,0.04612794612794613,0.9538720538720539,1326,0.22087542087542086,0.33265993265993266,0.44646464646464645
2269,37175,443,0,41,206,443,443,1.0,0.0,1.0,196,0.09255079006772009,0.4650112866817156,0.44243792325056436
2270,37175,1729,127,379,535,1602,1729,1.0,0.07345286292654714,0.9265471370734528,815,0.21920185078079815,0.3094274146905726,0.47137073452862926
2271,37175,2020,6,287,858,2014,2020,1.0,0.0029702970297029703,0.997029702970297,875,0.14207920792079207,0.42475247524752474,0.43316831683168316
2272,37175,2584,16,501,1022,2568,2584,1.0,0.006191950464396285,0.9938080495356038,1061,0.19388544891640866,0.3955108359133127,0.41060371517027866
2273,37175,1902,102,629,627,1800,1902,1.0,0.05362776025236593,0.9463722397476341,646,0.33070452155625657,0.32965299684542587,0.33964248159831756
2274,37175,1906,394,631,393,1512,1906,1.0,0.20671563483735572,0.7932843651626443,882,0.3310598111227702,0.2061909758656873,0.4627492130115425
2275,37175,1541,14,359,728,1527,1541,1.0,0.009085009733939001,0.990914990266061,454,0.23296560674886438,0.47242050616482806,0.2946138870863076
2276,37175,1943,83,575,478,1860,1943,1.0,0.04271744724652599,0.957282552753474,890,0.2959341224909933,0.24601132269686052,0.4580545548121462
2277,37175,1599,8,480,695,1591,1599,1.0,0.0050031269543464665,0.9949968730456535,424,0.300187617260788,0.4346466541588493,0.26516572858036275
2278,37175,2085,76,663,532,2009,2085,1.0,0.03645083932853717,0.9635491606714628,890,0.31798561151079136,0.2551558752997602,0.42685851318944845
2279,37175,2376,7,739,918,2369,2376,1.0,0.002946127946127946,0.9970538720538721,719,0.31102693602693604,0.38636363636363635,0.3026094276094276
2280,37175,754,1,235,291,753,754,1.0,0.001326259946949602,0.9986737400530504,228,0.3116710875331565,0.3859416445623342,0.30238726790450926
2281,37175,579,2,67,241,577,579,1.0,0.0034542314335060447,0.9965457685664939,271,0.1157167530224525,0.4162348877374784,0.4680483592400691
2282,37175,619,1,100,319,618,619,1.0,0.0016155088852988692,0.9983844911147012,200,0.16155088852988692,0.5153473344103393,0.32310177705977383
2283,37175,684,0,120,225,684,684,1.0,0.0,1.0,339,0.17543859649122806,0.32894736842105265,0.4956140350877193
2284,37175,980,0,267,372,980,980,1.0,0.0,1.0,341,0.2724489795918367,0.3795918367346939,0.3479591836734694
2285,37177,72,5,4,42,67,72,1.0,0.06944444444444445,0.9305555555555556,26,0.05555555555555555,0.5833333333333334,0.3611111111111111
2286,37177,275,95,83,72,180,275,1.0,0.34545454545454546,0.6545454545454545,120,0.3018181818181818,0.26181818181818184,0.43636363636363634
2287,37177,279,213,155,20,66,279,1.0,0.7634408602150538,0.23655913978494625,104,0.5555555555555556,0.07168458781362007,0.3727598566308244
2288,37177,2414,890,413,609,1524,2414,1.0,0.36868268434134216,0.6313173156586578,1392,0.17108533554266778,0.2522783761391881,0.5766362883181442
2289,37177,532,207,175,171,325,532,1.0,0.3890977443609023,0.6109022556390977,186,0.32894736842105265,0.32142857142857145,0.34962406015037595
2290,37177,40,9,7,16,31,40,1.0,0.225,0.775,17,0.175,0.4,0.425
2291,37179,2430,253,542,1158,2177,2430,1.0,0.10411522633744856,0.8958847736625515,730,0.22304526748971193,0.4765432098765432,0.3004115226337449
2292,37179,2546,111,604,1678,2435,2546,1.0,0.04359780047132757,0.9564021995286724,264,0.23723487824037706,0.6590730557737627,0.10369206598586017
2293,37179,2454,115,372,1191,2339,2454,1.0,0.04686226568867156,0.9531377343113284,891,0.15158924205378974,0.48533007334963324,0.363080684596577
2294,37179,11747,856,3066,7192,10891,11747,1.0,0.07286966885162169,0.9271303311483783,1489,0.261002809227888,0.6122414233421299,0.12675576742998212
2295,37179,2454,96,560,1412,2358,2454,1.0,0.039119804400977995,0.960880195599022,482,0.22819885900570497,0.5753871230643847,0.19641401792991034
2296,37179,2168,138,450,976,2030,2168,1.0,0.06365313653136531,0.9363468634686347,742,0.20756457564575645,0.45018450184501846,0.3422509225092251
2297,37179,3118,181,694,1898,2937,3118,1.0,0.058050032071840924,0.9419499679281591,526,0.22257857601026299,0.608723540731238,0.16869788325849905
2298,37179,3443,393,938,1304,3050,3443,1.0,0.11414464130119083,0.8858553586988092,1201,0.2724368283473715,0.3787394713912286,0.3488237002613999
2299,37179,1621,808,669,73,813,1621,1.0,0.4984577421344849,0.5015422578655151,879,0.41270820481184456,0.04503392967304133,0.5422578655151141
2300,37179,4219,498,915,1240,3721,4219,1.0,0.11803744963261437,0.8819625503673857,2064,0.21687603697558663,0.2939085091253852,0.4892154538990282
2301,37179,3918,393,947,1965,3525,3918,1.0,0.1003062787136294,0.8996937212863706,1006,0.24170495150587035,0.501531393568147,0.25676365492598263
2302,37179,3431,438,788,1315,2993,3431,1.0,0.1276595744680851,0.8723404255319149,1328,0.22967064995628098,0.38327018361993587,0.38705916642378313
2303,37179,2397,60,287,1443,2337,2397,1.0,0.025031289111389236,0.9749687108886108,667,0.11973299958281185,0.6020025031289111,0.278264497288277
2304,37179,4162,393,1036,1574,3769,4162,1.0,0.09442575684766939,0.9055742431523306,1552,0.24891878904372897,0.37818356559346467,0.37289764536280634
2305,37179,2157,78,462,1459,2079,2157,1.0,0.03616133518776078,0.9638386648122392,236,0.2141863699582754,0.6764024107556792,0.10941121928604543
2306,37179,2225,201,443,917,2024,2225,1.0,0.09033707865168539,0.9096629213483146,865,0.1991011235955056,0.41213483146067414,0.3887640449438202
2307,37179,2154,198,456,771,1956,2154,1.0,0.09192200557103064,0.9080779944289693,927,0.2116991643454039,0.3579387186629526,0.43036211699164345
2308,37179,3410,373,750,1249,3037,3410,1.0,0.1093841642228739,0.8906158357771261,1411,0.21994134897360704,0.3662756598240469,0.413782991202346
2309,37179,2620,955,834,123,1665,2620,1.0,0.36450381679389315,0.6354961832061069,1663,0.3183206106870229,0.046946564885496186,0.6347328244274809
2310,37179,2506,598,556,177,1908,2506,1.0,0.2386272944932163,0.7613727055067837,1773,0.22186751795690343,0.07063048683160415,0.7075019952114924
2311,37179,3245,410,676,1518,2835,3245,1.0,0.1263482280431433,0.8736517719568567,1051,0.20832049306625577,0.46779661016949153,0.3238828967642527
2312,37179,2004,126,331,923,1878,2004,1.0,0.06287425149700598,0.937125748502994,750,0.16516966067864272,0.4605788423153693,0.37425149700598803
2313,37179,2351,397,482,920,1954,2351,1.0,0.16886431305827307,0.8311356869417269,949,0.2050191407911527,0.3913228413441089,0.4036580178647384
2314,37179,2103,244,335,903,1859,2103,1.0,0.11602472658107466,0.8839752734189253,865,0.15929624346172136,0.42938659058487877,0.4113171659533999
2315,37179,3716,1112,1173,628,2604,3716,1.0,0.2992465016146394,0.7007534983853606,1915,0.3156620021528525,0.1689989235737352,0.5153390742734123
2316,37179,2624,13,268,1575,2611,2624,1.0,0.004954268292682927,0.995045731707317,781,0.10213414634146341,0.6002286585365854,0.2976371951219512
2317,37179,2103,132,291,1100,1971,2103,1.0,0.06276747503566334,0.9372325249643366,712,0.1383737517831669,0.5230622919638611,0.3385639562529719
2318,37179,1620,543,640,244,1077,1620,1.0,0.3351851851851852,0.6648148148148149,736,0.3950617283950617,0.1506172839506173,0.454320987654321
2319,37179,1961,422,448,305,1539,1961,1.0,0.21519632840387556,0.7848036715961244,1208,0.22845486996430392,0.15553289138194798,0.6160122386537481
2320,37179,2125,671,843,368,1454,2125,1.0,0.31576470588235295,0.684235294117647,914,0.3967058823529412,0.1731764705882353,0.43011764705882355
2321,37179,2211,200,396,915,2011,2211,1.0,0.09045680687471733,0.9095431931252826,900,0.1791044776119403,0.41383989145183175,0.40705563093622793
2322,37179,2552,162,367,1175,2390,2552,1.0,0.06347962382445141,0.9365203761755486,1010,0.14380877742946707,0.460423197492163,0.3957680250783699
2323,37179,1717,735,742,303,982,1717,1.0,0.4280722189866045,0.5719277810133955,672,0.4321490972626674,0.17647058823529413,0.3913803145020384
2324,37179,2149,220,359,868,1929,2149,1.0,0.10237319683573755,0.8976268031642625,922,0.1670544439274081,0.40390879478827363,0.4290367612843183
2325,37179,2972,200,610,1582,2772,2972,1.0,0.06729475100942127,0.9327052489905787,780,0.20524899057873486,0.5323014804845222,0.26244952893674295
2326,37179,3224,172,717,1892,3052,3224,1.0,0.05334987593052109,0.9466501240694789,615,0.22239454094292804,0.586848635235732,0.19075682382133996
2327,37179,1751,101,333,601,1650,1751,1.0,0.05768132495716733,0.9423186750428326,817,0.1901770416904626,0.3432324386065106,0.46659051970302684
2328,37179,4710,681,1088,1701,4029,4710,1.0,0.1445859872611465,0.8554140127388535,1921,0.23099787685774947,0.3611464968152866,0.4078556263269639
2329,37179,3793,243,848,1859,3550,3793,1.0,0.06406538360137094,0.9359346163986291,1086,0.22356973372001054,0.4901133667281835,0.28631689955180595
2330,37179,4273,314,1002,1850,3959,4273,1.0,0.07348467119120056,0.9265153288087994,1421,0.2344956704891177,0.43295108822841094,0.3325532412824713
2331,37179,2328,18,246,1402,2310,2328,1.0,0.007731958762886598,0.9922680412371134,680,0.1056701030927835,0.602233676975945,0.2920962199312715
2332,37179,1797,44,394,1021,1753,1797,1.0,0.02448525319977741,0.9755147468002225,382,0.21925431274346133,0.5681691708402894,0.2125765164162493
2333,37179,2524,32,260,1414,2492,2524,1.0,0.012678288431061807,0.9873217115689382,850,0.10301109350237718,0.5602218700475435,0.3367670364500792
2334,37179,3079,421,943,1273,2658,3079,1.0,0.13673270542383892,0.8632672945761611,863,0.30626826891848,0.41344592400129915,0.28028580708022083
2335,37179,3154,235,677,1486,2919,3154,1.0,0.07450856055802156,0.9254914394419784,991,0.21464806594800254,0.47114774889029803,0.31420418516169946
2336,37179,3815,545,1353,1426,3270,3815,1.0,0.14285714285714285,0.8571428571428571,1036,0.3546526867627785,0.37378768020969855,0.27155963302752295
2337,37179,2455,153,573,1129,2302,2455,1.0,0.06232179226069246,0.9376782077393075,753,0.23340122199592667,0.45987780040733195,0.30672097759674133
2338,37179,1276,60,269,824,1216,1276,1.0,0.047021943573667714,0.9529780564263323,183,0.21081504702194356,0.64576802507837,0.14341692789968652
2339,37179,1600,113,440,787,1487,1600,1.0,0.070625,0.929375,373,0.275,0.491875,0.233125
2340,37181,504,18,83,313,486,504,1.0,0.03571428571428571,0.9642857142857143,108,0.16468253968253968,0.621031746031746,0.21428571428571427
2341,37181,1220,590,412,287,630,1220,1.0,0.48360655737704916,0.5163934426229508,521,0.3377049180327869,0.23524590163934425,0.42704918032786887
2342,37181,2587,1586,1139,253,1001,2587,1.0,0.6130653266331658,0.3869346733668342,1195,0.440278314650174,0.09779667568612292,0.46192500966370315
2343,37181,1089,537,408,283,552,1089,1.0,0.4931129476584022,0.5068870523415978,398,0.3746556473829201,0.2598714416896235,0.3654729109274564
2344,37181,2875,1344,1221,750,1531,2875,1.0,0.46747826086956523,0.5325217391304348,904,0.42469565217391303,0.2608695652173913,0.3144347826086957
2345,37181,2145,733,702,695,1412,2145,1.0,0.3417249417249417,0.6582750582750583,748,0.32727272727272727,0.32400932400932403,0.3487179487179487
2346,37181,2477,1254,1165,593,1223,2477,1.0,0.5062575696406943,0.4937424303593056,719,0.4703270084779976,0.2394025030278563,0.29027048849414616
2347,37181,916,429,351,191,487,916,1.0,0.4683406113537118,0.5316593886462883,374,0.38318777292576417,0.20851528384279475,0.40829694323144106
2348,37181,4829,1859,1561,1117,2970,4829,1.0,0.38496583143507973,0.6150341685649203,2151,0.3232553323669497,0.23131083039966868,0.44543383723338165
2349,37181,1188,443,380,141,745,1188,1.0,0.3728956228956229,0.627104377104377,667,0.31986531986531985,0.11868686868686869,0.5614478114478114
2350,37181,937,536,411,150,401,937,1.0,0.5720384204909285,0.4279615795090715,376,0.4386339381003202,0.16008537886872998,0.4012806830309498
2351,37181,2565,2116,1426,113,449,2565,1.0,0.8249512670565302,0.1750487329434698,1026,0.5559454191033139,0.04405458089668616,0.4
2352,37181,988,503,349,101,485,988,1.0,0.5091093117408907,0.4908906882591093,538,0.3532388663967611,0.10222672064777327,0.5445344129554656
2353,37181,2298,1863,1379,78,435,2298,1.0,0.8107049608355091,0.18929503916449086,841,0.6000870322019147,0.033942558746736295,0.365970409051349
2354,37181,2930,839,1058,1099,2091,2930,1.0,0.2863481228668942,0.7136518771331058,773,0.36109215017064844,0.3750853242320819,0.2638225255972696
2355,37181,4333,1509,1278,1265,2824,4333,1.0,0.34825755827371335,0.6517424417262866,1790,0.2949457650588507,0.2919455342718671,0.41310870066928224
2356,37183,5746,1027,2288,1523,4719,5746,1.0,0.17873303167420815,0.8212669683257918,1935,0.39819004524886875,0.2650539505743126,0.33675600417681867
2357,37183,1065,36,487,482,1029,1065,1.0,0.03380281690140845,0.9661971830985916,96,0.4572769953051643,0.45258215962441317,0.09014084507042254
2358,37183,2972,496,1278,890,2476,2972,1.0,0.16689098250336473,0.8331090174966352,804,0.4300134589502019,0.29946164199192465,0.27052489905787347
2359,37183,2050,353,898,701,1697,2050,1.0,0.1721951219512195,0.8278048780487804,451,0.4380487804878049,0.34195121951219515,0.22
2360,37183,4117,510,1636,1551,3607,4117,1.0,0.1238766091814428,0.8761233908185572,930,0.39737673062909884,0.3767306290988584,0.22589264027204276
2361,37183,4708,591,1807,1626,4117,4708,1.0,0.12553101104502973,0.8744689889549703,1275,0.38381478334749364,0.3453695836873407,0.2708156329651657
2362,37183,1603,49,643,832,1554,1603,1.0,0.03056768558951965,0.9694323144104804,128,0.40112289457267625,0.5190268247036806,0.07985028072364317
2363,37183,2020,127,865,943,1893,2020,1.0,0.06287128712871287,0.9371287128712872,212,0.4282178217821782,0.46683168316831686,0.10495049504950495
2364,37183,3025,799,1366,543,2226,3025,1.0,0.2641322314049587,0.7358677685950413,1116,0.4515702479338843,0.17950413223140496,0.3689256198347107
2365,37183,2298,93,917,1285,2205,2298,1.0,0.04046997389033943,0.9595300261096605,96,0.3990426457789382,0.5591818973020017,0.04177545691906005
2366,37183,4045,241,1619,1828,3804,4045,1.0,0.05957972805933251,0.9404202719406675,598,0.40024721878862796,0.4519159456118665,0.14783683559950556
2367,37183,2239,330,968,710,1909,2239,1.0,0.14738722644037516,0.8526127735596248,561,0.4323358642251005,0.31710585082626175,0.2505582849486378
2368,37183,2931,466,1159,934,2465,2931,1.0,0.15899010576595018,0.8410098942340498,838,0.39542818150801773,0.31866257250085295,0.2859092459911293
2369,37183,4338,475,1619,1397,3863,4338,1.0,0.1094974642692485,0.8905025357307514,1322,0.3732134624250807,0.3220378054402951,0.3047487321346243
2370,37183,2577,741,788,896,1836,2577,1.0,0.28754365541327126,0.7124563445867288,893,0.30578191695770274,0.3476911136980986,0.3465269693441987
2371,37183,4180,1488,1642,912,2692,4180,1.0,0.3559808612440191,0.6440191387559808,1626,0.392822966507177,0.21818181818181817,0.3889952153110048
2372,37183,2484,526,740,1082,1958,2484,1.0,0.21175523349436393,0.788244766505636,662,0.29790660225442833,0.4355877616747182,0.2665056360708535
2373,37183,1580,202,325,667,1378,1580,1.0,0.12784810126582277,0.8721518987341772,588,0.20569620253164558,0.4221518987341772,0.3721518987341772
2374,37183,4526,1183,1465,1185,3343,4526,1.0,0.26137870083959347,0.7386212991604065,1876,0.32368537339814407,0.26182059213433495,0.414494034467521
2375,37183,3047,868,1094,945,2179,3047,1.0,0.284870364292747,0.7151296357072531,1008,0.35904168034131934,0.31014112241549063,0.33081719724319003
2376,37183,6439,2163,2783,1992,4276,6439,1.0,0.33592172697623857,0.6640782730237614,1664,0.43220997049231247,0.30936480820003104,0.2584252213076565
2377,37183,4524,691,1959,1286,3833,4524,1.0,0.15274093722369583,0.8472590627763041,1279,0.4330238726790451,0.28426171529619804,0.28271441202475683
2378,37183,4193,348,1642,1387,3845,4193,1.0,0.08299546863820653,0.9170045313617935,1164,0.3916050560457906,0.3307894109229669,0.2776055330312425
2379,37183,4855,476,1328,2437,4379,4855,1.0,0.098043254376931,0.901956745623069,1090,0.2735324407826982,0.501956745623069,0.22451081359423275
2380,37183,3947,772,1453,1515,3175,3947,1.0,0.1955915885482645,0.8044084114517355,979,0.36812769191791234,0.38383582467696986,0.2480364834051178
2381,37183,4129,320,929,1836,3809,4129,1.0,0.07750060547348026,0.9224993945265197,1364,0.2249939452651974,0.444659723904093,0.33034633083070963
2382,37183,6146,610,2009,3082,5536,6146,1.0,0.09925154572079402,0.900748454279206,1055,0.32687927107061504,0.5014643670680117,0.17165636186137326
2383,37183,3096,405,940,1400,2691,3096,1.0,0.1308139534883721,0.8691860465116279,756,0.30361757105943155,0.45219638242894056,0.2441860465116279
2384,37183,2799,370,779,1158,2429,2799,1.0,0.1321900678813862,0.8678099321186138,862,0.278313683458378,0.4137191854233655,0.3079671311182565
2385,37183,4374,1030,1717,1522,3344,4374,1.0,0.23548239597622314,0.7645176040237769,1135,0.39254686785550985,0.3479652491998171,0.25948788294467307
2386,37183,3148,393,1056,1493,2755,3148,1.0,0.12484116899618805,0.875158831003812,599,0.3354510800508259,0.47426937738246505,0.190279542566709
2387,37183,6342,2764,2793,643,3578,6342,1.0,0.4358246609902239,0.5641753390097761,2906,0.44039735099337746,0.10138757489750867,0.45821507410911383
2388,37183,2130,195,770,894,1935,2130,1.0,0.09154929577464789,0.9084507042253521,466,0.3615023474178404,0.4197183098591549,0.2187793427230047
2389,37183,2375,839,1186,474,1536,2375,1.0,0.35326315789473683,0.6467368421052632,715,0.4993684210526316,0.19957894736842105,0.30105263157894735
2390,37183,3139,525,1226,1219,2614,3139,1.0,0.16725071678878622,0.8327492832112138,694,0.3905702453010513,0.3883402357438675,0.22108951895508125
2391,37183,2166,646,1043,556,1520,2166,1.0,0.2982456140350877,0.7017543859649122,567,0.48153277931671284,0.2566943674976916,0.26177285318559557
2392,37183,3258,1392,1514,372,1866,3258,1.0,0.427255985267035,0.572744014732965,1372,0.46470227133210557,0.1141804788213628,0.4211172498465316
2393,37183,4596,1847,2384,793,2749,4596,1.0,0.40187119234116625,0.5981288076588338,1419,0.5187119234116623,0.17254134029590948,0.3087467362924282
2394,37183,5316,495,2013,2442,4821,5316,1.0,0.09311512415349887,0.9068848758465011,861,0.37866817155756205,0.45936794582392776,0.16196388261851016
2395,37183,3004,260,1110,1470,2744,3004,1.0,0.08655126498002663,0.9134487350199734,424,0.36950732356857524,0.48934753661784286,0.1411451398135819
2396,37183,782,49,193,361,733,782,1.0,0.06265984654731457,0.9373401534526854,228,0.24680306905370844,0.4616368286445013,0.2915601023017903
2397,37183,4493,176,1166,2652,4317,4493,1.0,0.03917204540396172,0.9608279545960383,675,0.2595148008012464,0.5902515023369687,0.150233696861785
2398,37183,4593,480,1205,1993,4113,4593,1.0,0.10450685826257348,0.8954931417374266,1395,0.2623557587633355,0.4339211844110603,0.3037230568256042
2399,37183,5947,742,1756,2351,5205,5947,1.0,0.12476879098705229,0.8752312090129477,1840,0.295274928535396,0.39532537413822094,0.30939969732638306
2400,37183,4664,482,1178,2252,4182,4664,1.0,0.10334476843910806,0.8966552315608919,1234,0.2525728987993139,0.48284734133790735,0.2645797598627787
2401,37183,2136,308,707,1046,1828,2136,1.0,0.1441947565543071,0.8558052434456929,383,0.3309925093632959,0.4897003745318352,0.1793071161048689
2402,37183,3235,521,794,1034,2714,3235,1.0,0.16105100463678515,0.8389489953632149,1407,0.2454404945904173,0.319629057187017,0.4349304482225657
2403,37183,5972,3034,3183,678,2938,5972,1.0,0.5080375083724046,0.4919624916275954,2111,0.5329872739450771,0.11352980576021433,0.3534829202947086
2404,37183,2079,597,763,480,1482,2079,1.0,0.28715728715728717,0.7128427128427128,836,0.367003367003367,0.23088023088023088,0.4021164021164021
2405,37183,2657,737,1073,987,1920,2657,1.0,0.27738050432818967,0.7226194956718103,597,0.4038389160707565,0.37147158449379,0.22468949943545352
2406,37183,3147,549,1024,1045,2598,3147,1.0,0.1744518589132507,0.8255481410867492,1078,0.32538925961232923,0.3320622815379727,0.34254845884969815
2407,37183,1906,713,752,389,1193,1906,1.0,0.3740818467995803,0.6259181532004198,765,0.3945435466946485,0.20409233997901363,0.40136411332633787
2408,37183,3454,708,1489,1316,2746,3454,1.0,0.20497973364215402,0.795020266357846,649,0.43109438332368266,0.3810075275043428,0.18789808917197454
2409,37183,7287,4457,4681,783,2830,7287,1.0,0.6116371620694387,0.38836283793056126,1823,0.6423768354604089,0.10745162618361466,0.2501715383559764
2410,37183,3562,1071,1447,961,2491,3562,1.0,0.30067377877596857,0.6993262212240314,1154,0.40623245367770916,0.2697922515440764,0.32397529477821446
2411,37183,3791,1371,1583,610,2420,3791,1.0,0.361646003692957,0.638353996307043,1598,0.4175679240305988,0.16090741229227118,0.42152466367713004
2412,37183,1335,230,358,362,1105,1335,1.0,0.17228464419475656,0.8277153558052435,615,0.26816479400749066,0.2711610486891386,0.4606741573033708
2413,37183,6829,2105,3284,1781,4724,6829,1.0,0.3082442524527749,0.691755747547225,1764,0.48089032069117,0.26079953141016254,0.25831014789866746
2414,37183,5441,1581,2389,1534,3860,5441,1.0,0.2905715861054953,0.7094284138945047,1518,0.43907369968755744,0.2819334681124793,0.27899283219996324
2415,37183,4411,1649,2145,906,2762,4411,1.0,0.3738381319428701,0.6261618680571299,1360,0.486284289276808,0.2053956019043301,0.30832010881886196
2416,37183,2524,448,627,828,2076,2524,1.0,0.1774960380348653,0.8225039619651348,1069,0.24841521394611726,0.32805071315372425,0.4235340729001585
2417,37183,4330,2284,2438,433,2046,4330,1.0,0.5274826789838337,0.4725173210161663,1459,0.5630484988452656,0.1,0.33695150115473443
2418,37183,7157,2343,3467,2044,4814,7157,1.0,0.32737180382841974,0.6726281961715803,1646,0.4844208467234875,0.2855945228447674,0.22998463043174514
2419,37183,3666,2462,2425,184,1204,3666,1.0,0.6715766503000545,0.32842334969994547,1057,0.6614839061647573,0.050190943807965085,0.2883251500272777
2420,37183,1735,555,682,368,1180,1735,1.0,0.31988472622478387,0.6801152737752162,685,0.3930835734870317,0.21210374639769453,0.39481268011527376
2421,37183,5204,1813,2273,735,3391,5204,1.0,0.34838585703305147,0.6516141429669485,2196,0.4367794004611837,0.14123750960799386,0.42198308993082245
2422,37183,7951,1272,2490,1195,6679,7951,1.0,0.1599798767450635,0.8400201232549365,4266,0.313168154949063,0.15029556030687963,0.5365362847440573
2423,37183,4144,135,1349,2328,4009,4144,1.0,0.032577220077220075,0.9674227799227799,467,0.32553088803088803,0.5617760617760618,0.11269305019305019
2424,37183,2073,67,830,1022,2006,2073,1.0,0.032320308731307285,0.9676796912686927,221,0.4003859141341052,0.49300530631934397,0.10660877954655089
2425,37183,4347,428,1335,1777,3919,4347,1.0,0.09845870715435932,0.9015412928456407,1235,0.30710835058661146,0.4087876696572349,0.28410397975615365
2426,37183,4200,90,1760,2259,4110,4200,1.0,0.02142857142857143,0.9785714285714285,181,0.41904761904761906,0.5378571428571428,0.043095238095238096
2427,37183,4740,723,1840,1055,4017,4740,1.0,0.15253164556962026,0.8474683544303797,1845,0.3881856540084388,0.22257383966244726,0.38924050632911394
2428,37183,3335,250,968,1636,3085,3335,1.0,0.07496251874062969,0.9250374812593704,731,0.2902548725637181,0.49055472263868066,0.2191904047976012
2429,37183,4581,392,1621,1488,4189,4581,1.0,0.0855708360619952,0.9144291639380048,1472,0.35385287055228115,0.32481990831696134,0.32132722113075746
2430,37183,3135,296,916,1321,2839,3135,1.0,0.09441786283891547,0.9055821371610845,898,0.29218500797448166,0.42137161084529506,0.2864433811802233
2431,37183,5528,920,2211,2540,4608,5528,1.0,0.16642547033285093,0.8335745296671491,777,0.39996382054992763,0.459479015918958,0.14055716353111433
2432,37183,2979,140,756,1681,2839,2979,1.0,0.04699563611950319,0.9530043638804968,542,0.2537764350453172,0.5642833165491776,0.1819402484055052
2433,37183,7269,980,2441,3150,6289,7269,1.0,0.13481909478607787,0.8651809052139221,1678,0.33580960242124086,0.4333470903838217,0.2308433071949374
2434,37183,2357,788,906,758,1569,2357,1.0,0.3343232923207467,0.6656767076792532,693,0.38438693254136613,0.3215952481968604,0.29401781926177345
2435,37183,3851,513,1141,1767,3338,3851,1.0,0.1332121526876136,0.8667878473123863,943,0.29628667878473125,0.4588418592573358,0.244871461957933
2436,37183,5410,623,1908,3009,4787,5410,1.0,0.11515711645101663,0.8848428835489833,493,0.35268022181146025,0.5561922365988909,0.0911275415896488
2437,37183,2613,296,901,1125,2317,2613,1.0,0.11327975507079985,0.8867202449292002,587,0.344814389590509,0.4305396096440873,0.22464600076540375
2438,37183,4442,489,1444,2027,3953,4442,1.0,0.11008554705087799,0.889914452949122,971,0.325078793336335,0.45632597928860874,0.2185952273750563
2439,37183,3054,739,1100,1125,2315,3054,1.0,0.24197773411918794,0.758022265880812,829,0.3601833660772757,0.36836935166994106,0.27144728225278325
2440,37183,4393,1405,2184,1247,2988,4393,1.0,0.3198269974960164,0.6801730025039836,962,0.49715456407921693,0.28386068745731846,0.2189847484634646
2441,37183,3760,721,1334,980,3039,3760,1.0,0.19175531914893618,0.8082446808510638,1446,0.3547872340425532,0.26063829787234044,0.38457446808510637
2442,37183,12034,1073,5111,4323,10961,12034,1.0,0.08916403523350507,0.910835964766495,2600,0.42471331228186804,0.3592321755027422,0.21605451221538974
2443,37183,2714,129,1070,1267,2585,2714,1.0,0.0475313190862196,0.9524686809137805,377,0.39425202652910835,0.46683861459100956,0.1389093588798821
2444,37183,3568,131,1404,1276,3437,3568,1.0,0.0367152466367713,0.9632847533632287,888,0.39349775784753366,0.3576233183856502,0.24887892376681614
2445,37183,3287,168,1339,1629,3119,3287,1.0,0.05111043504715546,0.9488895649528445,319,0.40736233647703074,0.49558868268938244,0.09704898083358686
2446,37183,7301,729,2781,2896,6572,7301,1.0,0.09984933570743734,0.9001506642925626,1624,0.38090672510614987,0.39665799205588276,0.2224352828379674
2447,37183,4572,306,1672,1852,4266,4572,1.0,0.06692913385826772,0.9330708661417323,1048,0.3657042869641295,0.40507436570428695,0.22922134733158356
2448,37183,2294,95,1012,1131,2199,2294,1.0,0.04141238012205754,0.9585876198779425,151,0.44115082824760243,0.493025283347864,0.06582388840453357
2449,37183,3211,94,1350,1274,3117,3211,1.0,0.029274369355341015,0.970725630644659,587,0.4204297726564933,0.3967611336032389,0.18280909374026783
2450,37183,3531,205,1221,1583,3326,3531,1.0,0.05805720758991787,0.9419427924100822,727,0.34579439252336447,0.44831492495043895,0.20589068252619655
2451,37183,2530,111,917,1154,2419,2530,1.0,0.04387351778656127,0.9561264822134388,459,0.3624505928853755,0.4561264822134387,0.18142292490118578
2452,37183,2313,303,1095,418,2010,2313,1.0,0.1309987029831388,0.8690012970168612,800,0.47341115434500647,0.18071768266320795,0.34587116299178555
2453,37183,3005,165,1039,621,2840,3005,1.0,0.05490848585690516,0.9450915141430949,1345,0.34575707154742097,0.20665557404326124,0.4475873544093178
2454,37183,1901,29,794,925,1872,1901,1.0,0.015255128879537085,0.9847448711204629,182,0.4176749079431878,0.486586007364545,0.09573908469226723
2455,37183,1187,16,492,528,1171,1187,1.0,0.013479359730412805,0.9865206402695872,167,0.4144903117101938,0.44481887110362256,0.14069081718618365
2456,37183,1084,74,425,528,1010,1084,1.0,0.06826568265682657,0.9317343173431735,131,0.39206642066420666,0.4870848708487085,0.12084870848708487
2457,37183,2760,82,1334,740,2678,2760,1.0,0.029710144927536233,0.9702898550724638,686,0.48333333333333334,0.26811594202898553,0.24855072463768116
2458,37183,1921,301,1134,401,1620,1921,1.0,0.1566892243623113,0.8433107756376887,386,0.5903175429463821,0.20874544508068715,0.20093701197293076
2459,37183,1146,14,649,287,1132,1146,1.0,0.012216404886561954,0.987783595113438,210,0.5663176265270506,0.25043630017452007,0.18324607329842932
2460,37183,1321,17,678,585,1304,1321,1.0,0.012869038607115822,0.9871309613928841,58,0.5132475397426193,0.4428463285389856,0.04390613171839516
2461,37183,1918,10,584,1333,1908,1918,1.0295381310418905,0.005213764337851929,0.9947862356621481,1,0.3044838373305527,0.6949947862356621,0.0005213764337851929
2462,37183,1890,221,784,546,1669,1890,1.0,0.11693121693121693,0.8830687830687831,560,0.4148148148148148,0.28888888888888886,0.2962962962962963
2463,37183,1664,406,947,263,1258,1664,1.0,0.2439903846153846,0.7560096153846154,454,0.5691105769230769,0.1580528846153846,0.27283653846153844
2464,37183,3503,725,2134,578,2778,3503,1.0,0.20696545817870396,0.7930345418212961,791,0.6091921210391094,0.16500142734798745,0.22580645161290322
2465,37183,1485,99,722,692,1386,1485,1.0,0.06666666666666667,0.9333333333333333,71,0.4861952861952862,0.465993265993266,0.04781144781144781
2466,37183,3230,456,1219,744,2774,3230,1.0,0.1411764705882353,0.8588235294117647,1267,0.37739938080495355,0.23034055727554179,0.39226006191950463
2467,37183,1130,19,428,501,1111,1130,1.0,0.016814159292035398,0.9831858407079646,201,0.3787610619469027,0.4433628318584071,0.17787610619469027
2468,37183,4124,789,1361,931,3335,4124,1.0,0.19131910766246363,0.8086808923375364,1832,0.33001939864209506,0.2257516973811833,0.44422890397672166
2469,37183,2167,1653,1558,36,514,2167,1.0,0.7628057221965852,0.23719427780341487,573,0.7189663128749423,0.01661282879556991,0.26442085832948775
2470,37183,2860,2104,1691,125,756,2860,1.0,0.7356643356643356,0.26433566433566436,1044,0.5912587412587412,0.043706293706293704,0.365034965034965
2471,37183,5231,1624,2017,816,3607,5231,1.0,0.31045689160772316,0.6895431083922768,2398,0.3855859300324986,0.15599311795067863,0.4584209520168228
2472,37183,3791,2950,2720,65,841,3791,1.0,0.7781587971511474,0.22184120284885256,1006,0.7174887892376681,0.017145871801635452,0.26536533896069636
2473,37183,12065,1940,3035,1682,10125,12065,1.0,0.16079569001243266,0.8392043099875673,7348,0.25155408205553254,0.13941152092830503,0.6090343970161625
2474,37183,868,706,291,16,162,868,1.0,0.8133640552995391,0.18663594470046083,561,0.3352534562211982,0.018433179723502304,0.6463133640552995
2475,37183,4854,3327,2000,91,1527,4854,1.0,0.6854140914709518,0.3145859085290482,2763,0.4120313143798929,0.018747424804285127,0.569221260815822
2476,37183,2472,699,1146,271,1773,2472,1.0,0.2827669902912621,0.7172330097087378,1055,0.46359223300970875,0.10962783171521036,0.4267799352750809
2477,37183,3996,2365,2774,488,1631,3996,1.0,0.5918418418418419,0.40815815815815815,734,0.6941941941941941,0.12212212212212212,0.18368368368368368
2478,37183,2139,36,901,1084,2103,2139,1.0,0.016830294530154277,0.9831697054698457,154,0.4212248714352501,0.506778868630201,0.07199625993454885
2479,37183,1198,48,532,588,1150,1198,1.0,0.04006677796327212,0.9599332220367279,78,0.44407345575959933,0.49081803005008345,0.0651085141903172
2480,37183,6803,1492,2156,589,5311,6803,1.0,0.21931500808466853,0.7806849919153315,4058,0.3169190063207408,0.08657945024254006,0.5965015434367191
2481,37183,3516,637,1320,589,2879,3516,1.0,0.1811717861205916,0.8188282138794084,1607,0.37542662116040953,0.16751990898748578,0.45705346985210465
2482,37183,1638,92,791,511,1546,1638,1.0,0.05616605616605617,0.9438339438339438,336,0.4829059829059829,0.31196581196581197,0.20512820512820512
2483,37183,2607,2281,1798,34,326,2607,1.0,0.874952052167242,0.12504794783275797,775,0.6896816263904871,0.01304181051016494,0.2972765630993479
2484,37183,3252,2329,1938,25,923,3252,1.0,0.7161746617466175,0.2838253382533825,1289,0.5959409594095941,0.007687576875768758,0.39637146371463716
2485,37183,1829,157,604,901,1672,1829,1.0,0.08583925642427556,0.9141607435757244,324,0.3302351011481684,0.4926189174412247,0.1771459814106069
2486,37183,1900,146,827,746,1754,1900,1.0,0.07684210526315789,0.9231578947368421,327,0.43526315789473685,0.39263157894736844,0.17210526315789473
2487,37183,2810,702,1222,657,2108,2810,1.0,0.2498220640569395,0.7501779359430605,931,0.43487544483985763,0.23380782918149468,0.3313167259786477
2488,37183,3068,813,1468,734,2255,3068,1.0,0.264993481095176,0.7350065189048239,866,0.4784876140808344,0.2392438070404172,0.28226857887874834
2489,37183,5942,4121,3413,140,1821,5942,1.0,0.6935375294513632,0.30646247054863685,2389,0.5743857287108718,0.023561090541905083,0.4020531807472232
2490,37183,3791,371,1049,494,3420,3791,1.0,0.09786336059087312,0.9021366394091269,2248,0.276707992614086,0.13030862569242943,0.5929833816934845
2491,37183,2766,187,946,1470,2579,2766,1.0,0.06760665220535068,0.9323933477946493,350,0.3420101229211858,0.5314533622559653,0.1265365148228489
2492,37183,3220,744,1224,587,2476,3220,1.0,0.231055900621118,0.768944099378882,1409,0.3801242236024845,0.18229813664596273,0.4375776397515528
2493,37183,4577,1178,1898,1020,3399,4577,1.0,0.25737382564998906,0.7426261743500109,1659,0.41468210618308937,0.22285339742189206,0.3624644963950186
2494,37183,2586,483,788,649,2103,2586,1.0,0.18677494199535963,0.8132250580046404,1149,0.3047177107501933,0.2509667440061872,0.4443155452436195
2495,37183,5226,2281,2127,265,2945,5226,1.0,0.4364714887102947,0.5635285112897053,2834,0.4070034443168771,0.0507079984691925,0.5422885572139303
2496,37183,2126,119,798,1061,2007,2126,1.0,0.055973659454374415,0.9440263405456256,267,0.3753527751646284,0.49905926622765756,0.12558795860771402
2497,37183,2680,331,1288,529,2349,2680,1.0,0.12350746268656716,0.8764925373134328,863,0.48059701492537316,0.19738805970149254,0.3220149253731343
2498,37183,3773,987,1717,667,2786,3773,1.0,0.26159554730983303,0.738404452690167,1389,0.4550755367081898,0.1767824012721972,0.368142062019613
2499,37183,2451,2066,2021,57,385,2451,1.0,0.842921256629947,0.15707874337005304,373,0.8245614035087719,0.023255813953488372,0.1521827825377397
2500,37183,1187,124,545,466,1063,1187,1.0,0.10446503791069923,0.8955349620893007,176,0.45914069081718617,0.392586352148273,0.14827295703454085
2501,37183,3019,191,1151,1503,2828,3019,1.0,0.06326598211328255,0.9367340178867175,365,0.3812520702219278,0.4978469691950977,0.12090096058297449
2502,37183,4735,287,1538,2616,4448,4735,1.0,0.06061246040126716,0.9393875395987329,581,0.3248152059134108,0.552481520591341,0.12270327349524815
2503,37183,2617,73,863,1586,2544,2617,1.0,0.027894535727932747,0.9721054642720672,168,0.3297669086740543,0.6060374474589224,0.06419564386702331
2504,37183,2191,76,717,1311,2115,2191,1.0,0.03468735737106344,0.9653126426289366,163,0.32724783204016433,0.5983569146508444,0.07439525330899133
2505,37183,937,31,364,555,906,937,1.0,0.033084311632870865,0.9669156883671292,18,0.38847385272145146,0.5923159018143009,0.0192102454642476
2506,37183,2382,102,764,1510,2280,2382,1.0,0.042821158690176324,0.9571788413098237,108,0.32073887489504616,0.6339210747271201,0.04534005037783375
2507,37183,2255,271,838,1169,1984,2255,1.0,0.12017738359201774,0.8798226164079823,248,0.3716186252771619,0.5184035476718404,0.10997782705099779
2508,37183,2451,281,1027,733,2170,2451,1.0,0.11464708282333741,0.8853529171766625,691,0.4190126478988168,0.29906160750713995,0.28192574459404324
2509,37183,3764,270,1195,881,3494,3764,1.0,0.07173219978746015,0.9282678002125399,1688,0.31748140276301806,0.2340595111583422,0.44845908607863977
2510,37183,2616,451,1022,579,2165,2616,1.0,0.17240061162079512,0.8275993883792049,1015,0.39067278287461776,0.2213302752293578,0.38799694189602446
2511,37183,2565,453,801,514,2112,2565,1.0,0.17660818713450294,0.8233918128654971,1250,0.312280701754386,0.20038986354775828,0.4873294346978557
2512,37183,2877,172,1378,1063,2705,2877,1.0,0.059784497740702124,0.9402155022592978,436,0.47897115050399725,0.3694820994091067,0.15154675008689608
2513,37183,3019,189,1268,1179,2830,3019,1.0,0.06260351109638954,0.9373964889036105,572,0.4200066247101689,0.39052666445842993,0.18946671083140113
2514,37183,2548,35,969,1493,2513,2548,1.0,0.013736263736263736,0.9862637362637363,86,0.38029827315541603,0.5859497645211931,0.033751962323390894
2515,37183,2491,343,1114,655,2148,2491,1.0,0.1376957045363308,0.8623042954636692,722,0.4472099558410277,0.2629466077880369,0.28984343637093535
2516,37183,2649,158,1004,1143,2491,2649,1.0,0.05964514911287278,0.9403548508871272,502,0.3790109475273688,0.43148357870894677,0.1895054737636844
2517,37183,2890,144,1158,1075,2746,2890,1.0,0.04982698961937716,0.9501730103806229,657,0.4006920415224913,0.3719723183391003,0.22733564013840832
2518,37183,1935,269,798,438,1666,1935,1.0,0.13901808785529715,0.8609819121447029,699,0.4124031007751938,0.22635658914728682,0.3612403100775194
2519,37183,2781,117,1196,1140,2664,2781,1.0,0.042071197411003236,0.9579288025889967,445,0.4300611290902553,0.4099244875943905,0.1600143833153542
2520,37183,4279,224,1824,1591,4055,4279,1.0,0.05234867959803693,0.9476513204019631,864,0.42626781958401494,0.3718158448235569,0.20191633559242814
2521,37183,1772,85,730,692,1687,1772,1.0,0.04796839729119639,0.9520316027088036,350,0.41196388261851014,0.3905191873589165,0.19751693002257337
2522,37183,2197,166,1107,795,2031,2197,1.0,0.0755575785161584,0.9244424214838416,295,0.5038689121529358,0.3618570778334092,0.134274010013655
2523,37183,2215,115,991,732,2100,2215,1.0,0.05191873589164785,0.9480812641083521,492,0.4474040632054176,0.33047404063205416,0.22212189616252823
2524,37183,2110,192,922,631,1918,2110,1.0,0.0909952606635071,0.9090047393364928,557,0.4369668246445498,0.2990521327014218,0.26398104265402844
2525,37183,2874,263,1151,887,2611,2874,1.0,0.09151009046624912,0.9084899095337509,836,0.40048712595685454,0.30862908837856645,0.290883785664579
2526,37183,1747,50,781,751,1697,1747,1.0,0.028620492272467088,0.9713795077275329,215,0.4470520892959359,0.4298797939324556,0.12306811677160848
2527,37183,3636,377,1370,919,3259,3636,1.0,0.10368536853685369,0.8963146314631463,1347,0.3767876787678768,0.25275027502750275,0.3704620462046205
2528,37183,2480,522,965,357,1958,2480,1.0,0.21048387096774193,0.7895161290322581,1158,0.38911290322580644,0.1439516129032258,0.4669354838709677
2529,37183,4628,585,1747,1342,4043,4628,1.0,0.12640449438202248,0.8735955056179775,1539,0.37748487467588593,0.2899740708729473,0.33254105445116683
2530,37183,3321,284,1114,1328,3037,3321,1.0,0.08551641071966275,0.9144835892803372,879,0.33544113218909966,0.39987955435109906,0.2646793134598013
2531,37183,10250,1123,4168,2318,9127,10250,1.0,0.1095609756097561,0.8904390243902439,3764,0.4066341463414634,0.22614634146341464,0.36721951219512194
2532,37183,6911,1335,2745,2028,5576,6911,1.0,0.19317030820431197,0.8068296917956881,2138,0.3971928809144842,0.2934452322384604,0.3093618868470554
2533,37183,4796,191,1827,1990,4605,4796,1.0,0.03982485404503753,0.9601751459549625,979,0.38094245204336946,0.41492910758965806,0.20412844036697247
2534,37183,7386,1169,2945,3327,6217,7386,1.0,0.15827240725697264,0.8417275927430273,1114,0.39872732196046573,0.450446791226645,0.15082588681288925
2535,37183,2467,526,1060,836,1941,2467,1.0,0.21321443048236724,0.7867855695176328,571,0.4296716659910823,0.3388731252533441,0.23145520875557357
2536,37183,2887,154,954,1703,2733,2887,1.0,0.05334257014201593,0.9466574298579841,230,0.3304468306200208,0.5898856944925528,0.0796674748874264
2537,37183,3555,477,1232,1361,3078,3555,1.0,0.1341772151898734,0.8658227848101265,962,0.3465541490857947,0.3828410689170183,0.27060478199718707
2538,37183,4304,537,1706,1769,3767,4304,1.0,0.12476765799256506,0.8752323420074349,829,0.39637546468401486,0.41101301115241634,0.19261152416356878
2539,37183,2164,348,837,549,1816,2164,1.0,0.16081330868761554,0.8391866913123844,778,0.3867837338262477,0.25369685767097966,0.35951940850277264
2540,37183,1578,299,688,570,1279,1578,1.0,0.18948035487959441,0.8105196451204055,320,0.43599493029150826,0.3612167300380228,0.20278833967046894
2541,37183,1592,96,660,694,1496,1592,1.0,0.06030150753768844,0.9396984924623115,238,0.41457286432160806,0.435929648241206,0.14949748743718594
2542,37183,4834,983,2115,1235,3851,4834,1.0,0.20335126189491104,0.796648738105089,1484,0.43752585850227554,0.2554820024824162,0.30699213901530825
2543,37183,2023,318,832,683,1705,2023,1.0,0.15719228868017796,0.842807711319822,508,0.4112703905091448,0.3376173999011369,0.25111220958971825
2544,37183,3420,182,1337,1633,3238,3420,1.0,0.05321637426900585,0.9467836257309942,450,0.39093567251461986,0.47748538011695907,0.13157894736842105
2545,37183,4501,376,1756,1698,4125,4501,1.0,0.08353699177960454,0.9164630082203955,1047,0.3901355254387914,0.37724950011108643,0.2326149744501222
2546,37183,3748,413,1479,1069,3335,3748,1.0,0.11019210245464248,0.8898078975453575,1200,0.39461045891141944,0.2852187833511206,0.32017075773745995
2547,37185,1066,98,216,416,968,1066,1.0,0.09193245778611632,0.9080675422138836,434,0.2026266416510319,0.3902439024390244,0.4071294559099437
2548,37185,1161,325,331,422,836,1161,1.0,0.27993109388458226,0.7200689061154177,408,0.285099052540913,0.363479758828596,0.35142118863049093
2549,37185,912,244,244,355,668,912,1.0,0.2675438596491228,0.7324561403508771,313,0.2675438596491228,0.3892543859649123,0.3432017543859649
2550,37185,586,294,275,157,292,586,1.0,0.5017064846416383,0.49829351535836175,154,0.46928327645051193,0.26791808873720135,0.2627986348122867
2551,37185,1164,561,456,264,603,1164,1.0,0.48195876288659795,0.5180412371134021,444,0.3917525773195876,0.2268041237113402,0.38144329896907214
2552,37185,1311,515,801,81,796,1311,1.0,0.39282990083905417,0.6071700991609459,429,0.6109839816933639,0.06178489702517163,0.32723112128146453
2553,37185,2195,1507,745,144,688,2195,1.0,0.6865603644646925,0.3134396355353075,1306,0.33940774487471526,0.06560364464692484,0.5949886104783599
2554,37185,924,484,391,190,440,924,1.0,0.5238095238095238,0.47619047619047616,343,0.4231601731601732,0.20562770562770563,0.3712121212121212
2555,37185,1740,1053,875,254,687,1740,1.0,0.6051724137931035,0.39482758620689656,611,0.5028735632183908,0.14597701149425288,0.3511494252873563
2556,37185,819,346,267,210,473,819,1.0,0.42246642246642246,0.5775335775335775,342,0.326007326007326,0.2564102564102564,0.4175824175824176
2557,37185,1410,815,682,194,595,1410,1.0,0.5780141843971631,0.4219858156028369,534,0.4836879432624113,0.1375886524822695,0.37872340425531914
2558,37185,2008,1334,1046,241,674,2008,1.0,0.6643426294820717,0.33565737051792827,721,0.5209163346613546,0.1200199203187251,0.35906374501992033
2559,37185,1005,600,455,145,405,1005,1.0,0.5970149253731343,0.40298507462686567,405,0.4527363184079602,0.14427860696517414,0.40298507462686567
2560,37185,413,277,194,67,136,413,1.0,0.6707021791767555,0.32929782082324455,152,0.46973365617433416,0.162227602905569,0.36803874092009686
2561,37187,1521,836,689,311,685,1521,1.0,0.5496383957922419,0.45036160420775806,521,0.452991452991453,0.2044707429322814,0.3425378040762656
2562,37187,2726,1114,917,875,1612,2726,1.0,0.4086573734409391,0.5913426265590609,934,0.3363903154805576,0.32098312545854735,0.34262655906089506
2563,37187,1035,333,308,302,702,1035,1.0,0.3217391304347826,0.6782608695652174,425,0.2975845410628019,0.29178743961352654,0.4106280193236715
2564,37187,2235,1232,969,469,1003,2235,1.0,0.5512304250559285,0.4487695749440716,797,0.43355704697986575,0.2098434004474273,0.3565995525727069
2565,37187,1407,418,337,501,989,1407,1.0,0.2970859985785359,0.7029140014214641,569,0.23951670220326937,0.35607675906183367,0.40440653873489696
2566,37187,1261,837,613,164,424,1261,1.0,0.6637589214908802,0.3362410785091198,484,0.486122125297383,0.13005551149881048,0.3838223632038065
2567,37189,2348,7,824,966,2341,2348,1.0,0.002981260647359455,0.9970187393526405,558,0.35093696763202725,0.41141396933560476,0.23764906303236796
2568,37189,3611,36,1004,1408,3575,3611,1.0,0.009969537524231515,0.9900304624757685,1199,0.27803932428690115,0.38991968983661035,0.3320409858764885
2569,37189,2947,68,973,634,2879,2947,1.0,0.02307431286053614,0.9769256871394638,1340,0.33016627078384797,0.2151340346114693,0.45469969460468274
2570,37189,632,2,169,253,630,632,1.0,0.0031645569620253164,0.9968354430379747,210,0.2674050632911392,0.40031645569620256,0.3322784810126582
2571,37189,520,4,166,201,516,520,1.0,0.007692307692307693,0.9923076923076923,153,0.3192307692307692,0.38653846153846155,0.29423076923076924
2572,37189,3848,158,1233,773,3690,3848,1.0,0.04106029106029106,0.9589397089397089,1842,0.32042619542619544,0.2008835758835759,0.4786902286902287
2573,37189,1870,90,790,282,1780,1870,1.0,0.0481283422459893,0.9518716577540107,798,0.42245989304812837,0.15080213903743314,0.4267379679144385
2574,37189,3968,69,1262,1176,3899,3968,1.0,0.017389112903225805,0.9826108870967742,1530,0.3180443548387097,0.2963709677419355,0.3855846774193548
2575,37189,277,3,97,159,274,277,1.0,0.010830324909747292,0.9891696750902527,21,0.35018050541516244,0.5740072202166066,0.07581227436823104
2576,37189,2949,14,865,1197,2935,2949,1.0,0.004747371990505256,0.9952526280094948,887,0.29331976941336046,0.4059003051881994,0.3007799253984402
2577,37189,3238,51,925,954,3187,3238,1.0,0.015750463248919086,0.984249536751081,1359,0.2856701667696109,0.29462631253860405,0.41970352069178507
2578,37189,4391,80,1211,1147,4311,4391,1.0,0.018219084491004327,0.9817809155089957,2033,0.275791391482578,0.26121612388977455,0.46299248462764747
2579,37189,2014,20,397,857,1994,2014,1.0,0.009930486593843098,0.9900695134061569,760,0.1971201588877855,0.42552135054617674,0.37735849056603776
2580,37189,1313,4,276,443,1309,1313,1.0,0.0030464584920030465,0.996953541507997,594,0.2102056359482102,0.3373952779893374,0.4523990860624524
2581,37189,2505,18,626,936,2487,2505,1.0,0.00718562874251497,0.9928143712574851,943,0.2499001996007984,0.37365269461077844,0.37644710578842316
2582,37189,476,4,154,184,472,476,1.0,0.008403361344537815,0.9915966386554622,138,0.3235294117647059,0.3865546218487395,0.28991596638655465
2583,37189,2483,7,604,939,2476,2483,1.0,0.002819170358437374,0.9971808296415626,940,0.243254128070882,0.37817156665324203,0.37857430527587593
2584,37189,1084,4,208,500,1080,1084,1.0,0.0036900369003690036,0.996309963099631,376,0.1918819188191882,0.4612546125461255,0.34686346863468637
2585,37189,181,2,30,64,179,181,1.0,0.011049723756906077,0.988950276243094,87,0.16574585635359115,0.35359116022099446,0.48066298342541436
2586,37189,3350,109,1188,788,3241,3350,1.0,0.03253731343283582,0.9674626865671642,1374,0.3546268656716418,0.23522388059701493,0.4101492537313433
2587,37191,2679,617,547,574,2062,2679,1.0,0.23030981709593132,0.7696901829040687,1558,0.204180664427025,0.21425905188503172,0.5815602836879432
2588,37191,2191,1481,871,43,710,2191,1.0,0.6759470561387494,0.32405294386125055,1277,0.39753537197626654,0.019625741670470105,0.5828388863532633
2589,37191,3264,1249,1027,643,2015,3264,1.0,0.38265931372549017,0.6173406862745098,1594,0.31464460784313725,0.19699754901960784,0.4883578431372549
2590,37191,4565,703,550,1318,3862,4565,1.0,0.15399780941949617,0.8460021905805039,2697,0.12048192771084337,0.28871851040525737,0.5907995618838993
2591,37191,2284,1254,961,276,1030,2284,1.0,0.5490367775831874,0.45096322241681264,1047,0.420753064798599,0.12084063047285463,0.45840630472854643
2592,37191,2880,1195,934,700,1685,2880,1.0,0.4149305555555556,0.5850694444444444,1246,0.32430555555555557,0.24305555555555555,0.4326388888888889
2593,37191,5325,1203,886,1191,4122,5325,1.0,0.2259154929577465,0.7740845070422535,3248,0.1663849765258216,0.2236619718309859,0.6099530516431925
2594,37191,3549,429,421,1414,3120,3549,1.0,0.12087912087912088,0.8791208791208791,1714,0.11862496477881093,0.398422090729783,0.482952944491406
2595,37191,3688,343,411,1616,3345,3688,1.0,0.09300433839479393,0.9069956616052061,1661,0.11144251626898048,0.43817787418655096,0.45037960954446854
2596,37191,4337,1121,462,1298,3216,4337,1.0,0.2584735992621628,0.7415264007378373,2577,0.1065252478671893,0.29928522019829373,0.594189531934517
2597,37191,2055,1454,1017,271,601,2055,1.0,0.7075425790754258,0.2924574209245742,767,0.4948905109489051,0.1318734793187348,0.3732360097323601
2598,37191,2958,413,498,1644,2545,2958,1.0,0.13962136578769438,0.8603786342123056,816,0.16835699797160245,0.5557809330628803,0.27586206896551724
2599,37191,4506,612,683,2077,3894,4506,1.0,0.13581890812250333,0.8641810918774967,1746,0.1515756768752774,0.4609409675987572,0.38748335552596536
2600,37191,3914,662,648,1508,3252,3914,1.0,0.16913643331630046,0.8308635666836995,1758,0.1655595298926929,0.38528359734287176,0.44915687276443533
2601,37191,1845,1330,1044,58,515,1845,1.0,0.7208672086720868,0.2791327913279133,743,0.5658536585365853,0.03143631436314363,0.402710027100271
2602,37191,3045,656,600,1134,2389,3045,1.0,0.21543513957307062,0.7845648604269294,1311,0.19704433497536947,0.3724137931034483,0.43054187192118226
2603,37191,4825,1056,1031,1916,3769,4825,1.0,0.218860103626943,0.781139896373057,1878,0.21367875647668394,0.39709844559585494,0.3892227979274611
2604,37191,3200,799,708,956,2401,3200,1.0,0.2496875,0.7503125,1536,0.22125,0.29875,0.48
2605,37191,3576,481,662,1864,3095,3576,1.0,0.13450782997762864,0.8654921700223713,1050,0.18512304250559283,0.5212527964205816,0.2936241610738255
2606,37191,3295,156,278,1537,3139,3295,1.0,0.047344461305007586,0.9526555386949924,1480,0.08437025796661608,0.466464339908953,0.44916540212443096
2607,37191,2886,811,781,1077,2075,2886,1.0,0.28101178101178104,0.718988218988219,1028,0.27061677061677064,0.3731808731808732,0.3562023562023562
2608,37191,2291,696,641,629,1595,2291,1.0,0.3037974683544304,0.6962025316455697,1021,0.27979048450458316,0.2745525971191619,0.44565691837625493
2609,37191,2816,622,483,1025,2194,2816,1.0,0.22088068181818182,0.7791193181818182,1308,0.17151988636363635,0.3639914772727273,0.46448863636363635
2610,37191,1914,1004,881,420,910,1914,1.0,0.5245559038662487,0.4754440961337513,613,0.46029258098223613,0.219435736677116,0.32027168234064785
2611,37191,1844,1526,1164,80,318,1844,1.0,0.8275488069414316,0.17245119305856832,600,0.631236442516269,0.04338394793926247,0.32537960954446854
2612,37191,1845,1273,966,150,572,1845,1.0,0.6899728997289973,0.3100271002710027,729,0.5235772357723577,0.08130081300813008,0.3951219512195122
2613,37191,4033,1348,1150,1016,2685,4033,1.0,0.3342424993801141,0.6657575006198859,1867,0.2851475328539549,0.2519216464170593,0.4629308207289859
2614,37191,2224,1063,1019,461,1161,2224,1.0,0.4779676258992806,0.5220323741007195,744,0.45818345323741005,0.2072841726618705,0.3345323741007194
2615,37191,2228,1130,950,469,1098,2228,1.0,0.507181328545781,0.49281867145421904,809,0.4263913824057451,0.21050269299820468,0.3631059245960503
2616,37191,2077,1358,1003,240,719,2077,1.0,0.6538276360134809,0.346172363986519,834,0.48290804044294655,0.11555127587867116,0.4015406836783823
2617,37193,3126,19,379,1368,3107,3126,1.0,0.006078055022392835,0.9939219449776072,1379,0.12124120281509917,0.43761996161228406,0.44113883557261674
2618,37193,1025,2,117,372,1023,1025,1.0,0.001951219512195122,0.9980487804878049,536,0.11414634146341464,0.36292682926829267,0.5229268292682927
2619,37193,1561,10,168,603,1551,1561,1.0,0.0064061499039077515,0.9935938500960922,790,0.10762331838565023,0.3862908392056374,0.5060858424087123
2620,37193,4877,31,647,1967,4846,4877,1.0,0.006356366618823047,0.993643633381177,2263,0.13266352265737133,0.40332171416854623,0.4640147631740824
2621,37193,2735,239,577,809,2496,2735,1.0,0.08738574040219378,0.9126142595978062,1349,0.2109689213893967,0.29579524680073127,0.493235831809872
2622,37193,1030,18,115,397,1012,1030,1.0,0.017475728155339806,0.9825242718446602,518,0.11165048543689321,0.38543689320388347,0.5029126213592233
2623,37193,1408,39,188,529,1369,1408,1.0,0.027698863636363636,0.9723011363636364,691,0.13352272727272727,0.3757102272727273,0.49076704545454547
2624,37193,1191,73,215,453,1118,1191,1.0,0.061293031066330814,0.9387069689336692,523,0.18052057094878254,0.380352644836272,0.43912678421494544
2625,37193,3177,449,614,655,2728,3177,1.0,0.14132829713566258,0.8586717028643375,1908,0.1932640856153604,0.20616934214667926,0.6005665722379604
2626,37193,2096,232,374,613,1864,2096,1.0,0.11068702290076336,0.8893129770992366,1109,0.1784351145038168,0.2924618320610687,0.5291030534351145
2627,37193,3168,329,613,1187,2839,3168,1.0,0.1038510101010101,0.89614898989899,1368,0.19349747474747475,0.3746843434343434,0.4318181818181818
2628,37193,971,0,86,390,971,971,1.0,0.0,1.0,495,0.08856848609680741,0.4016477857878476,0.509783728115345
2629,37193,1369,61,223,625,1308,1369,1.0,0.04455807158509861,0.9554419284149014,521,0.16289262235208182,0.4565376186997809,0.3805697589481373
2630,37193,836,56,133,329,780,836,1.0,0.06698564593301436,0.9330143540669856,374,0.1590909090909091,0.39354066985645936,0.4473684210526316
2631,37193,855,8,63,483,847,855,1.0,0.00935672514619883,0.9906432748538012,309,0.07368421052631578,0.5649122807017544,0.36140350877192984
2632,37193,807,2,81,333,805,807,1.0,0.0024783147459727386,0.9975216852540273,393,0.10037174721189591,0.41263940520446096,0.48698884758364314
2633,37193,459,4,89,201,455,459,1.0,0.008714596949891068,0.9912854030501089,169,0.19389978213507625,0.43790849673202614,0.3681917211328976
2634,37193,1966,14,330,740,1952,1966,1.0,0.007121057985757884,0.9928789420142421,896,0.167853509664293,0.37639877924720244,0.4557477110885046
2635,37193,2205,13,316,1021,2192,2205,1.0,0.0058956916099773245,0.9941043083900227,868,0.14331065759637188,0.46303854875283446,0.39365079365079364
2636,37193,2198,20,259,849,2178,2198,1.0,0.009099181073703366,0.9909008189262967,1090,0.1178343949044586,0.3862602365787079,0.4959053685168335
2637,37193,4386,34,552,1835,4352,4386,1.0,0.007751937984496124,0.9922480620155039,1999,0.12585499316005472,0.4183766529867761,0.45576835385316916
2638,37193,2476,48,309,862,2428,2476,1.0,0.01938610662358643,0.9806138933764136,1305,0.12479806138933765,0.3481421647819063,0.527059773828756
2639,37193,1792,200,352,612,1592,1792,1.0,0.11160714285714286,0.8883928571428571,828,0.19642857142857142,0.34151785714285715,0.46205357142857145
2640,37193,2318,99,373,961,2219,2318,1.0,0.04270923209663503,0.957290767903365,984,0.16091458153580673,0.41458153580672996,0.4245038826574633
2641,37193,2279,108,388,1025,2171,2279,1.0,0.04738920579201404,0.952610794207986,866,0.17025010969723564,0.44975866608161474,0.3799912242211496
2642,37193,2067,41,315,724,2026,2067,1.0,0.01983551040154814,0.9801644895984518,1028,0.15239477503628446,0.3502660861151427,0.49733913884857284
2643,37193,448,2,86,259,446,448,1.0,0.004464285714285714,0.9955357142857143,103,0.19196428571428573,0.578125,0.22991071428571427
2644,37193,978,59,186,313,919,978,1.0,0.06032719836400818,0.9396728016359919,479,0.1901840490797546,0.32004089979550104,0.4897750511247444
2645,37195,1852,1331,1093,92,521,1852,1.0,0.718682505399568,0.281317494600432,667,0.5901727861771058,0.04967602591792657,0.3601511879049676
2646,37195,1743,1271,847,36,472,1743,1.0,0.7292025243832473,0.2707974756167527,860,0.4859437751004016,0.020654044750430294,0.4934021801491681
2647,37195,1656,288,443,849,1368,1656,1.0,0.17391304347826086,0.8260869565217391,364,0.267512077294686,0.5126811594202898,0.21980676328502416
2648,37195,2517,729,785,1033,1788,2517,1.0,0.2896305125148987,0.7103694874851013,699,0.3118792212951927,0.410409217322209,0.27771156138259834
2649,37195,3955,574,717,1874,3381,3955,1.0,0.14513274336283186,0.8548672566371681,1364,0.18128950695322377,0.47383059418457646,0.3448798988621998
2650,37195,1857,934,635,102,923,1857,1.0,0.5029617662897146,0.4970382337102854,1120,0.341949380721594,0.05492730210016155,0.6031233171782445
2651,37195,1793,1003,811,273,790,1793,1.0,0.5593976575571667,0.44060234244283325,709,0.45231455660903513,0.15225878416062466,0.3954266592303402
2652,37195,3133,391,494,1354,2742,3133,1.0,0.12480051069262688,0.8751994893073731,1285,0.15767634854771784,0.4321736354931376,0.4101500159591446
2653,37195,2360,504,489,867,1856,2360,1.0,0.2135593220338983,0.7864406779661017,1004,0.20720338983050848,0.3673728813559322,0.42542372881355933
2654,37195,2611,2216,1802,76,395,2611,1.0,0.8487169666794332,0.15128303332056683,733,0.6901570279586365,0.02910762160091919,0.2807353504404443
2655,37195,4291,1601,1335,1350,2690,4291,1.0,0.37310650198089024,0.6268934980191098,1606,0.3111162899091121,0.3146119785597763,0.37427173153111165
2656,37195,6492,1682,1808,2504,4810,6492,1.0,0.25908810844115837,0.7409118915588416,2180,0.2784966112138016,0.38570548367221197,0.33579790511398644
2657,37195,1316,550,421,354,766,1316,1.0,0.41793313069908816,0.5820668693009119,541,0.31990881458966564,0.2689969604863222,0.41109422492401215
2658,37195,3861,1269,1435,1203,2592,3861,1.0,0.32867132867132864,0.6713286713286714,1223,0.37166537166537167,0.31157731157731156,0.3167573167573168
2659,37195,1239,982,691,19,257,1239,1.0,0.7925746569814366,0.20742534301856336,529,0.5577078288942696,0.01533494753833737,0.4269572235673931
2660,37195,4171,1375,1489,1548,2796,4171,1.0,0.32965715655718053,0.6703428434428195,1134,0.35698873171901224,0.3711340206185567,0.2718772476624311
2661,37195,1569,245,445,834,1324,1569,1.0,0.1561504142766093,0.8438495857233907,290,0.2836201402166985,0.5315487571701721,0.18483110261312938
2662,37195,768,651,519,4,117,768,1.0,0.84765625,0.15234375,245,0.67578125,0.005208333333333333,0.3190104166666667
2663,37195,2838,1043,914,765,1795,2838,1.0,0.3675123326286117,0.6324876673713883,1159,0.32205778717406625,0.26955602536997886,0.4083861874559549
2664,37195,1574,179,435,889,1395,1574,1.0,0.11372299872935197,0.886277001270648,250,0.27636594663278274,0.5648030495552732,0.1588310038119441
2665,37195,2376,1214,963,390,1162,2376,1.0,0.5109427609427609,0.4890572390572391,1023,0.4053030303030303,0.16414141414141414,0.4305555555555556
2666,37195,2721,1790,1224,82,931,2721,1.0,0.6578463800073502,0.34215361999264976,1415,0.4498346196251378,0.03013597941933113,0.5200294009555311
2667,37195,2966,535,539,1045,2431,2966,1.0,0.1803776129467296,0.8196223870532704,1382,0.18172623061362103,0.3523263654753877,0.4659474039109912
2668,37195,1523,552,541,411,971,1523,1.0,0.3624425476034143,0.6375574523965857,571,0.3552199606040709,0.26986211424819434,0.37491792514773475
2669,37197,3251,153,522,1420,3098,3251,1.0,0.047062442325438325,0.9529375576745617,1309,0.1605659796985543,0.4367886804060289,0.4026453398954168
2670,37197,2424,31,289,892,2393,2424,1.0,0.01278877887788779,0.9872112211221122,1243,0.11922442244224422,0.367986798679868,0.5127887788778878
2671,37197,2655,38,362,1091,2617,2655,1.0,0.01431261770244821,0.9856873822975518,1202,0.13634651600753295,0.4109227871939736,0.4527306967984934
2672,37197,3145,56,401,1656,3089,3145,1.0,0.0178060413354531,0.982193958664547,1088,0.1275039745627981,0.526550079491256,0.34594594594594597
2673,37197,1746,15,198,742,1731,1746,1.0,0.00859106529209622,0.9914089347079038,806,0.1134020618556701,0.424971363115693,0.4616265750286369
2674,37197,1166,5,133,604,1161,1166,1.0,0.004288164665523156,0.9957118353344768,429,0.11406518010291596,0.5180102915951973,0.36792452830188677
2675,37197,3605,267,590,1296,3338,3605,1.0,0.07406380027739251,0.9259361997226075,1719,0.1636615811373093,0.359500693481276,0.4768377253814147
2676,37197,4640,201,638,1740,4439,4640,1.0,0.04331896551724138,0.9566810344827587,2262,0.1375,0.375,0.4875
2677,37197,1007,13,146,413,994,1007,1.0,0.012909632571996028,0.9870903674280039,448,0.14498510427010924,0.41012909632572,0.4448857994041708
2678,37197,1952,36,218,871,1916,1952,1.0,0.018442622950819672,0.9815573770491803,863,0.11168032786885246,0.4462090163934426,0.4421106557377049
2679,37197,1429,6,146,728,1423,1429,1.0,0.004198740377886634,0.9958012596221134,555,0.10216934919524143,0.509447165850245,0.38838348495451364
2680,37197,2448,49,314,1125,2399,2448,1.0,0.020016339869281044,0.9799836601307189,1009,0.12826797385620914,0.45955882352941174,0.41217320261437906
2681,37199,489,1,158,169,488,489,1.0,0.002044989775051125,0.9979550102249489,162,0.3231083844580777,0.3456032719836401,0.3312883435582822
2682,37199,499,0,130,185,499,499,1.0,0.0,1.0,184,0.2605210420841683,0.37074148296593185,0.3687374749498998
2683,37199,414,1,127,128,413,414,1.0,0.0024154589371980675,0.9975845410628019,159,0.30676328502415456,0.30917874396135264,0.38405797101449274
2684,37199,1283,5,419,498,1278,1283,1.0,0.003897116134060795,0.9961028838659393,366,0.32657833203429465,0.3881527669524552,0.2852689010132502
2685,37199,1464,2,318,534,1462,1464,1.0,0.001366120218579235,0.9986338797814208,612,0.21721311475409835,0.36475409836065575,0.4180327868852459
2686,37199,2653,5,645,1086,2648,2653,1.0,0.0018846588767433095,0.9981153411232567,922,0.2431209950998869,0.4093479080286468,0.34753109687146627
2687,37199,3586,66,1056,1163,3520,3586,1.0,0.018404907975460124,0.9815950920245399,1367,0.294478527607362,0.32431678750697157,0.3812046848856665
2688,37199,1082,1,274,534,1081,1082,1.0,0.0009242144177449168,0.9990757855822551,274,0.2532347504621072,0.49353049907578556,0.2532347504621072
2689,37199,528,1,144,215,527,528,1.0,0.001893939393939394,0.9981060606060606,169,0.2727272727272727,0.4071969696969697,0.32007575757575757
2690,37199,1894,11,614,634,1883,1894,1.0,0.005807814149947202,0.9941921858500528,646,0.324181626187962,0.3347412882787751,0.34107708553326294
2691,37199,364,1,95,132,363,364,1.0,0.0027472527472527475,0.9972527472527473,137,0.260989010989011,0.3626373626373626,0.37637362637362637
