,COUNTY,VAP,NAME,WVAP,PRES16D,PRES16R,OVAP,TOT_VOTES,factor,WVAP_pct,OVAP_pct,PRES16None,PRES16D_pct,PRES16R_pct,PRES16None_pct
556,Baltimore City,1090,Baltimore City Precinct 26-028,142,250,16,948,1090,1.0,0.13027522935779817,0.8697247706422019,824,0.22935779816513763,0.014678899082568808,0.7559633027522936
557,Baltimore City,1429,Baltimore City Precinct 26-027,322,357,49,1107,1429,1.0,0.22533240027991602,0.7746675997200839,1023,0.2498250524842547,0.034289713086074175,0.7158852344296711
558,Baltimore City,1467,Baltimore City Precinct 27-007,472,364,42,995,1467,1.0,0.321745057941377,0.678254942058623,1061,0.24812542603953647,0.028629856850715747,0.7232447171097478
559,Baltimore City,985,Baltimore City Precinct 26-030,419,286,60,566,985,1.0,0.42538071065989846,0.5746192893401015,639,0.29035532994923857,0.06091370558375635,0.6487309644670051
574,Baltimore City,502,Baltimore City Precinct 26-001,417,63,77,85,502,1.0,0.8306772908366534,0.1693227091633466,362,0.1254980079681275,0.15338645418326693,0.7211155378486056
575,Baltimore City,2426,Baltimore City Precinct 26-002,1008,413,99,1418,2426,1.0,0.4154987633965375,0.5845012366034625,1914,0.17023907666941468,0.04080791426215993,0.7889530090684254
576,Baltimore City,2095,Baltimore City Precinct 26-003,1404,233,251,691,2095,1.0,0.6701670644391408,0.3298329355608592,1611,0.11121718377088305,0.1198090692124105,0.7689737470167064
581,Baltimore City,782,Baltimore City Precinct 26-005,514,115,74,268,782,1.0,0.6572890025575447,0.34271099744245526,593,0.14705882352941177,0.09462915601023018,0.7583120204603581
582,Baltimore City,1623,Baltimore City Precinct 26-004,1098,173,168,525,1623,1.0,0.6765249537892791,0.3234750462107209,1282,0.10659272951324707,0.10351201478743069,0.7898952556993223
583,Baltimore City,1434,Baltimore City Precinct 26-007,799,248,155,635,1434,1.0,0.5571827057182706,0.44281729428172945,1031,0.17294281729428174,0.10808926080892609,0.7189679218967922
584,Baltimore City,1562,Baltimore City Precinct 26-014,1050,141,152,512,1562,1.0,0.6722151088348272,0.32778489116517284,1269,0.09026888604353393,0.0973111395646607,0.8124199743918054
585,Baltimore City,1463,Baltimore City Precinct 26-015,116,463,19,1347,1463,1.0,0.07928913192071087,0.9207108680792891,981,0.316473000683527,0.012987012987012988,0.67053998632946
586,Baltimore City,4697,Baltimore City Precinct 26-029,597,1051,44,4100,4697,1.0,0.12710240579093038,0.8728975942090696,3602,0.22375984671066637,0.00936768149882904,0.7668724717905046
805,Baltimore City,3265,Baltimore City Precinct 25-005,822,653,117,2443,3265,1.0,0.2517611026033691,0.748238897396631,2495,0.2,0.035834609494640124,0.7641653905053599
807,Baltimore City,2660,Baltimore City Precinct 25-008,74,833,20,2586,2660,1.0,0.027819548872180452,0.9721804511278196,1807,0.3131578947368421,0.007518796992481203,0.6793233082706767
808,Baltimore City,1089,Baltimore City Precinct 25-009,9,472,3,1080,1089,1.0,0.008264462809917356,0.9917355371900827,614,0.43342516069788795,0.0027548209366391185,0.5638200183654729
809,Baltimore City,1595,Baltimore City Precinct 25-010,46,481,13,1549,1595,1.0,0.02884012539184953,0.9711598746081505,1101,0.30156739811912225,0.008150470219435737,0.690282131661442
810,Baltimore City,3555,Baltimore City Precinct 25-003,2570,496,414,985,3555,1.0,0.7229254571026723,0.2770745428973277,2645,0.13952180028129396,0.11645569620253164,0.7440225035161744
811,Baltimore City,929,Baltimore City Precinct 20-009,527,147,65,402,929,1.0,0.5672766415500539,0.4327233584499462,717,0.15823466092572658,0.06996770721205597,0.7717976318622174
812,Baltimore City,1049,Baltimore City Precinct 20-005,28,328,6,1021,1049,1.0,0.02669208770257388,0.9733079122974261,715,0.3126787416587226,0.005719733079122974,0.6816015252621545
813,Baltimore City,3568,Baltimore City Precinct 25-004,2774,378,469,794,3568,1.0,0.7774663677130045,0.22253363228699552,2721,0.10594170403587444,0.13144618834080718,0.7626121076233184
814,Baltimore City,756,Baltimore City Precinct 20-010,333,103,20,423,756,1.0,0.44047619047619047,0.5595238095238095,633,0.13624338624338625,0.026455026455026454,0.8373015873015873
815,Baltimore City,2322,Baltimore City Precinct 20-003,54,439,7,2268,2322,1.0,0.023255813953488372,0.9767441860465116,1876,0.18906115417743324,0.0030146425495262705,0.8079242032730405
816,Baltimore City,2303,Baltimore City Precinct 20-011,848,399,58,1455,2303,1.0,0.36821537125488496,0.6317846287451151,1846,0.17325227963525835,0.02518454190186713,0.8015631784628745
817,Baltimore City,950,Baltimore City Precinct 20-002,70,185,7,880,950,1.0,0.07368421052631578,0.9263157894736842,758,0.19473684210526315,0.007368421052631579,0.7978947368421052
818,Baltimore City,1760,Baltimore City Precinct 16-013,14,480,9,1746,1760,1.0,0.007954545454545454,0.9920454545454546,1271,0.2727272727272727,0.005113636363636364,0.7221590909090909
819,Baltimore City,1950,Baltimore City Precinct 16-012,10,608,10,1940,1950,1.0,0.005128205128205128,0.9948717948717949,1332,0.3117948717948718,0.005128205128205128,0.683076923076923
820,Baltimore City,240,Baltimore City Precinct 20-004,4,103,3,236,240,1.0,0.016666666666666666,0.9833333333333333,134,0.42916666666666664,0.0125,0.5583333333333333
821,Baltimore City,1495,Baltimore City Precinct 16-008,24,270,7,1471,1495,1.0,0.016053511705685617,0.9839464882943144,1218,0.1806020066889632,0.0046822742474916385,0.8147157190635451
822,Baltimore City,901,Baltimore City Precinct 26-031,516,173,119,385,901,1.0,0.5726970033296337,0.42730299667036625,609,0.19200887902330743,0.1320754716981132,0.6759156492785794
826,Baltimore City,2719,Baltimore City Precinct 27-008,1192,728,186,1527,2719,1.0,0.4383964692901802,0.5616035307098198,1805,0.267745494667157,0.06840750275836704,0.6638470025744759
827,Baltimore City,2670,Baltimore City Precinct 27-011,1688,680,393,982,2670,1.0,0.6322097378277154,0.36779026217228467,1597,0.2546816479400749,0.14719101123595504,0.59812734082397
828,Baltimore City,842,Baltimore City Precinct 27-010,645,205,151,197,842,1.0,0.7660332541567696,0.2339667458432304,486,0.24346793349168647,0.17933491686460806,0.5771971496437055
876,Baltimore City,1038,Baltimore City Precinct 12-011,130,355,19,908,1038,1.0,0.1252408477842004,0.8747591522157996,664,0.3420038535645472,0.018304431599229287,0.6396917148362236
877,Baltimore City,1718,Baltimore City Precinct 12-008,988,549,30,730,1718,1.0,0.5750873108265425,0.42491268917345754,1139,0.31955762514551805,0.017462165308498253,0.6629802095459837
878,Baltimore City,1916,Baltimore City Precinct 12-010,382,489,24,1534,1916,1.0,0.19937369519832984,0.8006263048016702,1403,0.25521920668058456,0.012526096033402923,0.7322546972860126
882,Baltimore City,1139,Baltimore City Precinct 25-011,672,140,123,467,1139,1.0,0.5899912203687445,0.4100087796312555,876,0.12291483757682177,0.10798946444249341,0.7690956979806848
883,Baltimore City,2273,Baltimore City Precinct 25-012,1279,263,215,994,2273,1.0,0.5626924769027717,0.4373075230972283,1795,0.11570611526616806,0.09458864936207655,0.7897052353717554
884,Baltimore City,1483,Baltimore City Precinct 25-014,468,310,43,1015,1483,1.0,0.3155765340525961,0.6844234659474039,1130,0.20903573836817263,0.02899527983816588,0.7619689817936615
885,Baltimore City,1262,Baltimore City Precinct 25-013,750,162,100,512,1262,1.0,0.5942947702060222,0.40570522979397783,1000,0.12836767036450078,0.07923930269413629,0.7923930269413629
886,Baltimore City,1628,Baltimore City Precinct 25-015,701,291,76,927,1628,1.0,0.4305896805896806,0.5694103194103194,1261,0.17874692874692874,0.04668304668304668,0.7745700245700246
887,Baltimore City,2415,Baltimore City Precinct 25-016,1616,255,206,799,2415,1.0,0.6691511387163561,0.3308488612836439,1954,0.10559006211180125,0.08530020703933748,0.8091097308488613
888,Baltimore City,2673,Baltimore City Precinct 24-004,2448,793,390,225,2673,1.0,0.9158249158249159,0.08417508417508418,1490,0.2966704077815189,0.14590347923681257,0.5574261129816686
889,Baltimore City,878,Baltimore City Precinct 24-002,775,312,111,103,878,1.0,0.8826879271070615,0.11731207289293849,455,0.3553530751708428,0.1264236902050114,0.5182232346241458
890,Baltimore City,722,Baltimore City Precinct 24-001,632,266,97,90,722,1.0,0.8753462603878116,0.12465373961218837,359,0.3684210526315789,0.13434903047091412,0.49722991689750695
891,Baltimore City,1728,Baltimore City Precinct 24-003,1531,606,208,197,1728,1.0,0.8859953703703703,0.11400462962962964,914,0.3506944444444444,0.12037037037037036,0.5289351851851852
892,Baltimore City,1994,Baltimore City Precinct 03-003,1421,434,168,573,1994,1.0,0.7126379137412236,0.28736208625877635,1392,0.2176529588766299,0.08425275827482448,0.6980942828485457
893,Baltimore City,3017,Baltimore City Precinct 24-005,2786,1015,598,231,3017,1.0,0.9234338747099768,0.0765661252900232,1404,0.33642691415313225,0.19821014252568778,0.46536294332118
894,Baltimore City,2635,Baltimore City Precinct 02-003,2167,772,206,468,2635,1.0,0.8223908918406072,0.1776091081593928,1657,0.29297912713472485,0.07817836812144212,0.628842504743833
895,Baltimore City,2074,Baltimore City Precinct 02-002,1402,476,143,672,2074,1.0,0.6759884281581485,0.3240115718418515,1455,0.22950819672131148,0.06894889103182257,0.7015429122468659
896,Baltimore City,2117,Baltimore City Precinct 01-002,1706,523,140,411,2117,1.0,0.8058573452999528,0.19414265470004724,1454,0.24704770902220122,0.06613131790269249,0.6868209730751063
897,Baltimore City,1947,Baltimore City Precinct 01-003,1710,385,193,237,1947,1.0,0.8782742681047766,0.12172573189522343,1369,0.1977401129943503,0.09912686183872625,0.7031330251669234
898,Baltimore City,2617,Baltimore City Precinct 05-001,202,440,14,2415,2617,1.0,0.07718761941153993,0.92281238058846,2163,0.1681314482231563,0.005349636988918609,0.826518914787925
899,Baltimore City,658,Baltimore City Precinct 10-004,17,202,1,641,658,1.0,0.025835866261398176,0.9741641337386018,455,0.3069908814589666,0.001519756838905775,0.6914893617021277
900,Baltimore City,5665,Baltimore City Precinct 10-003,789,150,3,4876,5665,1.0,0.13927625772285968,0.8607237422771403,5512,0.0264783759929391,0.000529567519858782,0.9729920564872021
901,Baltimore City,836,Baltimore City Precinct 03-002,231,199,26,605,836,1.0,0.27631578947368424,0.7236842105263158,611,0.23803827751196172,0.03110047846889952,0.7308612440191388
913,Baltimore City,2765,Baltimore City Precinct 07-004,124,567,12,2641,2765,1.0,0.04484629294755877,0.9551537070524412,2186,0.20506329113924052,0.00433996383363472,0.7905967450271247
914,Baltimore City,3497,Baltimore City Precinct 26-010,1389,459,176,2108,3497,1.0,0.3971975979410924,0.6028024020589077,2862,0.13125536173863311,0.050328853302830996,0.8184157849585358
915,Baltimore City,923,Baltimore City Precinct 26-012,85,195,11,838,923,1.0,0.09209100758396534,0.9079089924160346,717,0.2112676056338028,0.011917659804983749,0.7768147345612134
916,Baltimore City,3245,Baltimore City Precinct 08-010,18,934,16,3227,3245,1.0,0.005546995377503852,0.9944530046224962,2295,0.2878274268104777,0.004930662557781202,0.7072419106317411
917,Baltimore City,577,Baltimore City Precinct 08-011,13,189,5,564,577,1.0,0.022530329289428077,0.9774696707105719,383,0.3275563258232236,0.008665511265164644,0.6637781629116117
918,Baltimore City,1998,Baltimore City Precinct 08-003,70,534,16,1928,1998,1.0,0.035035035035035036,0.964964964964965,1448,0.2672672672672673,0.008008008008008008,0.7247247247247247
919,Baltimore City,1675,Baltimore City Precinct 26-019,143,492,18,1532,1675,1.0,0.0853731343283582,0.9146268656716418,1165,0.2937313432835821,0.010746268656716417,0.6955223880597015
920,Baltimore City,783,Baltimore City Precinct 26-020,50,249,5,733,783,1.0,0.06385696040868455,0.9361430395913155,529,0.31800766283524906,0.006385696040868455,0.6756066411238825
921,Baltimore City,1709,Baltimore City Precinct 26-011,785,151,87,924,1709,1.0,0.4593329432416618,0.5406670567583383,1471,0.08835576360444705,0.05090696313633704,0.8607372732592159
922,Baltimore City,1355,Baltimore City Precinct 26-013,1074,121,216,281,1355,1.0,0.792619926199262,0.207380073800738,1018,0.08929889298892989,0.15940959409594097,0.7512915129151292
923,Baltimore City,339,Baltimore City Precinct 26-017,33,182,4,306,339,1.0,0.09734513274336283,0.9026548672566371,153,0.5368731563421829,0.011799410029498525,0.45132743362831856
924,Baltimore City,2928,Baltimore City Precinct 26-018,256,859,35,2672,2928,1.0,0.08743169398907104,0.912568306010929,2034,0.2933743169398907,0.011953551912568305,0.694672131147541
925,Baltimore City,1249,Baltimore City Precinct 26-016,74,351,6,1175,1249,1.0,0.059247397918334666,0.9407526020816653,892,0.28102481985588473,0.004803843074459567,0.7141713370696557
982,Baltimore City,2683,Baltimore City Precinct 26-024,242,563,18,2441,2683,1.0,0.09019754006708908,0.9098024599329109,2102,0.20983973164368244,0.006708907938874394,0.7834513604174431
983,Baltimore City,2299,Baltimore City Precinct 26-025,146,434,25,2153,2299,1.0,0.06350587211831231,0.9364941278816877,1840,0.18877772944758592,0.01087429317094389,0.8003479773814702
984,Baltimore City,1812,Baltimore City Precinct 26-026,482,437,52,1330,1812,1.0,0.26600441501103755,0.7339955849889624,1323,0.24116997792494482,0.02869757174392936,0.7301324503311258
985,Baltimore City,2585,Baltimore City Precinct 27-005,1273,708,181,1312,2585,1.0,0.49245647969052225,0.5075435203094778,1696,0.27388781431334625,0.0700193423597679,0.6560928433268859
986,Baltimore City,3355,Baltimore City Precinct 27-006,959,877,129,2396,3355,1.0,0.28584202682563337,0.7141579731743666,2349,0.26140089418777945,0.03845007451564829,0.7001490312965722
987,Baltimore City,780,Baltimore City Precinct 27-019,33,228,8,747,780,1.0,0.04230769230769231,0.9576923076923077,544,0.2923076923076923,0.010256410256410256,0.6974358974358974
988,Baltimore City,2289,Baltimore City Precinct 27-015,400,664,64,1889,2289,1.0,0.17474879860200962,0.8252512013979904,1561,0.290083005679336,0.027959807776321538,0.6819571865443425
992,Baltimore City,2647,Baltimore City Precinct 27-014,1453,657,283,1194,2647,1.0,0.5489233094068757,0.4510766905931243,1707,0.24820551567812618,0.10691348696637704,0.6448809973554968
993,Baltimore City,3409,Baltimore City Precinct 27-013,915,819,144,2494,3409,1.0,0.26840715752420063,0.7315928424757994,2446,0.2402464065708419,0.042241126430038134,0.71751246699912
994,Baltimore City,1492,Baltimore City Precinct 27-009,843,453,152,649,1492,1.0,0.5650134048257373,0.43498659517426275,887,0.30361930294906164,0.10187667560321716,0.5945040214477212
995,Baltimore City,762,Baltimore City Precinct 27-012,550,149,107,212,762,1.0,0.7217847769028871,0.2782152230971129,506,0.19553805774278216,0.14041994750656167,0.6640419947506562
1014,Baltimore City,751,Baltimore City Precinct 27-037,547,225,62,204,751,1.0,0.7283621837549934,0.27163781624500666,464,0.2996005326231691,0.08255659121171771,0.6178428761651131
1015,Baltimore City,1727,Baltimore City Precinct 27-038,993,419,55,734,1727,1.0,0.57498552403011,0.42501447596989,1253,0.24261725535610887,0.03184713375796178,0.7255356108859293
1016,Baltimore City,1669,Baltimore City Precinct 27-042,1261,573,150,408,1669,1.0,0.7555422408627921,0.2444577591372079,946,0.3433193529059317,0.08987417615338526,0.566806470940683
1017,Baltimore City,1155,Baltimore City Precinct 27-044,1034,471,93,121,1155,1.0,0.8952380952380953,0.10476190476190476,591,0.4077922077922078,0.08051948051948052,0.5116883116883116
1018,Baltimore City,1487,Baltimore City Precinct 27-040,1289,514,182,198,1487,1.0,0.8668459986550101,0.13315400134498992,791,0.3456624075319435,0.12239408204438466,0.5319435104236718
1019,Baltimore City,742,Baltimore City Precinct 27-039,645,345,93,97,742,1.0,0.8692722371967655,0.1307277628032345,304,0.46495956873315364,0.12533692722371967,0.40970350404312667
1020,Baltimore City,1929,Baltimore City Precinct 27-041,1446,549,183,483,1929,1.0,0.749611197511664,0.25038880248833595,1197,0.2846034214618974,0.09486780715396578,0.6205287713841369
1036,Baltimore City,1338,Baltimore City Precinct 09-010,254,480,9,1084,1338,1.0,0.1898355754857997,0.8101644245142003,849,0.35874439461883406,0.006726457399103139,0.6345291479820628
1037,Baltimore City,1402,Baltimore City Precinct 09-003,246,483,17,1156,1402,1.0,0.1754636233951498,0.8245363766048502,902,0.34450784593437944,0.012125534950071327,0.6433666191155493
1038,Baltimore City,1166,Baltimore City Precinct 09-002,133,309,12,1033,1166,1.0,0.11406518010291596,0.885934819897084,845,0.26500857632933106,0.010291595197255575,0.7246998284734134
1039,Baltimore City,1002,Baltimore City Precinct 09-009,76,293,15,926,1002,1.0,0.07584830339321358,0.9241516966067864,694,0.29241516966067865,0.014970059880239521,0.6926147704590818
1040,Baltimore City,1958,Baltimore City Precinct 09-004,484,610,27,1474,1958,1.0,0.24719101123595505,0.7528089887640449,1321,0.3115423901940756,0.013789581205311542,0.6746680286006129
1041,Baltimore City,1717,Baltimore City Precinct 09-005,367,445,21,1350,1717,1.0,0.21374490390215492,0.786255096097845,1251,0.25917297612114154,0.0122306348281887,0.7285963890506698
1042,Baltimore City,782,Baltimore City Precinct 09-001,41,210,2,741,782,1.0,0.052429667519181586,0.9475703324808185,570,0.26854219948849106,0.0025575447570332483,0.7289002557544757
1043,Baltimore City,970,Baltimore City Precinct 27-036,32,291,6,938,970,1.0,0.032989690721649485,0.9670103092783505,673,0.3,0.006185567010309278,0.6938144329896907
1044,Baltimore City,3261,Baltimore City Precinct 27-035,98,600,21,3163,3261,1.0,0.03005213124808341,0.9699478687519166,2640,0.18399264029438822,0.006439742410303588,0.8095676172953082
1045,Baltimore City,1481,Baltimore City Precinct 27-026,265,185,13,1216,1481,1.0,0.17893315327481432,0.8210668467251857,1283,0.12491559756920999,0.008777852802160702,0.8663065496286293
1046,Baltimore City,1722,Baltimore City Precinct 27-027,33,374,7,1689,1722,1.0,0.01916376306620209,0.980836236933798,1341,0.21718931475029035,0.0040650406504065045,0.7787456445993032
1047,Baltimore City,1372,Baltimore City Precinct 27-028,32,323,7,1340,1372,1.0,0.023323615160349854,0.9766763848396501,1042,0.23542274052478135,0.00510204081632653,0.7594752186588921
1048,Baltimore City,858,Baltimore City Precinct 27-029,10,281,6,848,858,1.0,0.011655011655011656,0.9883449883449883,571,0.3275058275058275,0.006993006993006993,0.6655011655011654
1049,Baltimore City,1643,Baltimore City Precinct 09-008,18,462,15,1625,1643,1.0,0.010955569080949483,0.9890444309190505,1166,0.28119293974437004,0.009129640900791236,0.7096774193548387
1050,Baltimore City,1933,Baltimore City Precinct 09-006,142,581,17,1791,1933,1.0,0.0734609415416451,0.9265390584583549,1335,0.30056906363166064,0.008794619762027936,0.6906363166063114
1051,Baltimore City,1819,Baltimore City Precinct 09-007,152,612,17,1667,1819,1.0,0.08356239692138538,0.9164376030786147,1190,0.3364485981308411,0.009345794392523364,0.6542056074766355
1052,Baltimore City,1296,Baltimore City Precinct 27-025,35,332,17,1261,1296,1.0,0.02700617283950617,0.9729938271604939,947,0.25617283950617287,0.013117283950617283,0.7307098765432098
1053,Baltimore City,1047,Baltimore City Precinct 27-024,138,158,5,909,1047,1.0,0.1318051575931232,0.8681948424068768,884,0.15090735434574976,0.004775549188156638,0.8443170964660937
1054,Baltimore City,588,Baltimore City Precinct 27-023,30,202,8,558,588,1.0,0.05102040816326531,0.9489795918367347,378,0.3435374149659864,0.013605442176870748,0.6428571428571429
1055,Baltimore City,1632,Baltimore City Precinct 27-034,121,488,10,1511,1632,1.0,0.0741421568627451,0.9258578431372549,1134,0.29901960784313725,0.006127450980392157,0.6948529411764706
1056,Baltimore City,2316,Baltimore City Precinct 27-033,564,675,49,1752,2316,1.0,0.24352331606217617,0.7564766839378239,1592,0.2914507772020725,0.021157167530224525,0.687392055267703
1057,Baltimore City,2778,Baltimore City Precinct 27-032,1010,729,86,1768,2778,1.0,0.36357091432685384,0.6364290856731462,1963,0.26241900647948163,0.03095752339812815,0.7066234701223902
1060,Baltimore City,1703,Baltimore City Precinct 27-030,58,406,7,1645,1703,1.0,0.03405754550792719,0.9659424544920728,1290,0.2384028185554903,0.004110393423370522,0.7574867880211391
1061,Baltimore City,2334,Baltimore City Precinct 27-031,141,681,29,2193,2334,1.0,0.060411311053984576,0.9395886889460154,1624,0.2917737789203085,0.012425021422450729,0.6958011996572407
1062,Baltimore City,2547,Baltimore City Precinct 27-022,207,739,24,2340,2547,1.0,0.0812720848056537,0.9187279151943463,1784,0.2901452689438555,0.009422850412249705,0.7004318806438948
1063,Baltimore City,2765,Baltimore City Precinct 27-021,234,771,25,2531,2765,1.0,0.08462929475587704,0.915370705244123,1969,0.27884267631103077,0.009041591320072333,0.7121157323688969
1064,Baltimore City,2623,Baltimore City Precinct 27-020,377,622,32,2246,2623,1.0,0.14372855508959206,0.856271444910408,1969,0.2371330537552421,0.012199771254288982,0.750667174990469
1066,Baltimore City,1108,Baltimore City Precinct 08-001,657,26,5,451,1108,1.0,0.5929602888086642,0.40703971119133575,1077,0.023465703971119134,0.004512635379061372,0.9720216606498195
1067,Baltimore City,1540,Baltimore City Precinct 08-002,183,467,27,1357,1540,1.0,0.11883116883116883,0.8811688311688312,1046,0.30324675324675326,0.01753246753246753,0.6792207792207792
1068,Baltimore City,2756,Baltimore City Precinct 26-021,263,909,44,2493,2756,1.0,0.09542815674891146,0.9045718432510885,1803,0.32982583454281567,0.015965166908563134,0.6542089985486212
1069,Baltimore City,813,Baltimore City Precinct 26-022,102,234,10,711,813,1.0,0.12546125461254612,0.8745387453874539,569,0.2878228782287823,0.012300123001230012,0.6998769987699877
1070,Baltimore City,586,Baltimore City Precinct 27-002,406,263,49,180,586,1.0,0.6928327645051194,0.30716723549488056,274,0.44880546075085326,0.08361774744027303,0.46757679180887374
1071,Baltimore City,2370,Baltimore City Precinct 27-001,734,593,95,1636,2370,1.0,0.309704641350211,0.6902953586497891,1682,0.25021097046413504,0.04008438818565401,0.7097046413502109
1072,Baltimore City,3583,Baltimore City Precinct 27-018,801,564,92,2782,3583,1.0,0.22355567959810216,0.7764443204018978,2927,0.1574099916271281,0.025676807144850683,0.8169132012280212
1073,Baltimore City,1263,Baltimore City Precinct 27-017,466,389,64,797,1263,1.0,0.36896278701504354,0.6310372129849564,810,0.3079968329374505,0.050673000791765635,0.6413301662707839
1074,Baltimore City,642,Baltimore City Precinct 27-003,342,192,29,300,642,1.0,0.5327102803738317,0.4672897196261682,421,0.29906542056074764,0.045171339563862926,0.6557632398753894
1075,Baltimore City,676,Baltimore City Precinct 27-004,338,180,52,338,676,1.0,0.5,0.5,444,0.26627218934911245,0.07692307692307693,0.6568047337278107
1076,Baltimore City,796,Baltimore City Precinct 27-016,371,236,46,425,796,1.0,0.46608040201005024,0.5339195979899497,514,0.2964824120603015,0.05778894472361809,0.6457286432160804
1077,Baltimore City,1296,Baltimore City Precinct 26-023,120,366,23,1176,1296,1.0,0.09259259259259259,0.9074074074074074,907,0.2824074074074074,0.017746913580246913,0.6998456790123457
1078,Baltimore City,1224,Baltimore City Precinct 15-022,11,478,8,1213,1224,1.0,0.008986928104575163,0.9910130718954249,738,0.39052287581699346,0.006535947712418301,0.6029411764705882
1079,Baltimore City,2136,Baltimore City Precinct 15-024,9,534,9,2127,2136,1.0,0.004213483146067416,0.9957865168539326,1593,0.25,0.004213483146067416,0.7457865168539326
1080,Baltimore City,964,Baltimore City Precinct 27-055,16,260,2,948,964,1.0,0.016597510373443983,0.983402489626556,702,0.2697095435684647,0.002074688796680498,0.7282157676348547
1081,Baltimore City,951,Baltimore City Precinct 15-025,20,213,6,931,951,1.0,0.02103049421661409,0.9789695057833859,732,0.22397476340694006,0.006309148264984227,0.7697160883280757
1082,Baltimore City,614,Baltimore City Precinct 27-054,17,153,5,597,614,1.0,0.02768729641693811,0.9723127035830619,456,0.249185667752443,0.008143322475570033,0.742671009771987
1083,Baltimore City,804,Baltimore City Precinct 27-058,10,165,5,794,804,1.0,0.012437810945273632,0.9875621890547264,634,0.20522388059701493,0.006218905472636816,0.7885572139303483
1084,Baltimore City,1983,Baltimore City Precinct 27-053,65,490,10,1918,1983,1.0,0.03277861825516894,0.9672213817448311,1483,0.24710035300050429,0.005042864346949067,0.7478567826525466
1085,Baltimore City,3199,Baltimore City Precinct 27-052,85,631,14,3114,3199,1.0,0.026570803376055017,0.973429196623945,2554,0.19724914035636137,0.00437636761487965,0.798374492028759
1086,Baltimore City,2203,Baltimore City Precinct 15-023,61,535,12,2142,2203,1.0,0.027689514298683614,0.9723104857013164,1656,0.24285065819337268,0.005447117566954153,0.7517022242396731
1087,Baltimore City,1066,Baltimore City Precinct 13-005,806,290,95,260,1066,1.0,0.7560975609756098,0.24390243902439024,681,0.27204502814258913,0.08911819887429644,0.6388367729831145
1088,Baltimore City,1038,Baltimore City Precinct 27-048,156,285,20,882,1038,1.0,0.15028901734104047,0.8497109826589595,733,0.2745664739884393,0.019267822736030827,0.7061657032755299
1089,Baltimore City,827,Baltimore City Precinct 27-043,692,280,80,135,827,1.0,0.8367593712212817,0.16324062877871826,467,0.3385731559854897,0.09673518742442563,0.5646916565900847
1090,Baltimore City,1140,Baltimore City Precinct 27-050,691,490,38,449,1140,1.0,0.606140350877193,0.393859649122807,612,0.4298245614035088,0.03333333333333333,0.5368421052631579
1091,Baltimore City,390,Baltimore City Precinct 27-051,146,104,5,244,390,1.0,0.37435897435897436,0.6256410256410256,281,0.26666666666666666,0.01282051282051282,0.7205128205128205
1092,Baltimore City,2674,Baltimore City Precinct 27-049,2164,839,199,510,2674,1.0,0.8092744951383695,0.1907255048616305,1636,0.3137621540762902,0.07442034405385191,0.6118175018698578
1094,Baltimore City,777,Baltimore City Precinct 13-006,30,239,5,747,777,1.0,0.03861003861003861,0.9613899613899614,533,0.3075933075933076,0.006435006435006435,0.685971685971686
1095,Baltimore City,1244,Baltimore City Precinct 13-004,1098,351,184,146,1244,1.0,0.882636655948553,0.11736334405144695,709,0.2821543408360129,0.14790996784565916,0.569935691318328
1096,Baltimore City,2273,Baltimore City Precinct 13-003,1980,650,237,293,2273,1.0,0.8710954685437747,0.12890453145622524,1386,0.28596568411790585,0.10426748790145182,0.6097668279806423
1097,Baltimore City,2199,Baltimore City Precinct 13-011,1953,767,160,246,2199,1.0,0.888130968622101,0.11186903137789904,1272,0.3487949067758072,0.07276034561164166,0.5784447476125512
1098,Baltimore City,1290,Baltimore City Precinct 13-012,1174,682,142,116,1290,1.0,0.9100775193798449,0.08992248062015504,466,0.5286821705426357,0.11007751937984496,0.3612403100775194
1099,Baltimore City,2558,Baltimore City Precinct 13-001,1793,423,50,765,2558,1.0,0.700938232994527,0.29906176700547304,2085,0.1653635652853792,0.019546520719311962,0.8150899139953088
1100,Baltimore City,1628,Baltimore City Precinct 27-047,1104,394,134,524,1628,1.0,0.6781326781326781,0.32186732186732187,1100,0.24201474201474202,0.08230958230958231,0.6756756756756757
1101,Baltimore City,1385,Baltimore City Precinct 13-002,1103,424,129,282,1385,1.0,0.7963898916967509,0.2036101083032491,832,0.3061371841155235,0.09314079422382672,0.6007220216606498
1102,Baltimore City,802,Baltimore City Precinct 27-046,669,364,67,133,802,1.0,0.8341645885286783,0.1658354114713217,371,0.4538653366583541,0.08354114713216958,0.4625935162094763
1103,Baltimore City,4732,Baltimore City Precinct 27-045,3995,678,130,737,4732,1.0,0.8442519019442096,0.15574809805579037,3924,0.14327979712595096,0.027472527472527472,0.8292476754015216
1104,Baltimore City,1486,Baltimore City Precinct 12-003,862,344,44,624,1486,1.0,0.5800807537012113,0.4199192462987887,1098,0.23149394347240915,0.029609690444145357,0.7388963660834454
1105,Baltimore City,1587,Baltimore City Precinct 12-006,1031,353,25,556,1587,1.0,0.649653434152489,0.350346565847511,1209,0.22243226212980466,0.01575299306868305,0.7618147448015122
1106,Baltimore City,1914,Baltimore City Precinct 12-005,1218,446,29,696,1914,1.0,0.6363636363636364,0.36363636363636365,1439,0.2330198537095089,0.015151515151515152,0.7518286311389759
1107,Baltimore City,3814,Baltimore City Precinct 12-004,2068,495,39,1746,3814,1.0,0.5422128998426848,0.45778710015731516,3280,0.12978500262191925,0.010225485055060305,0.8599895123230205
1108,Baltimore City,2306,Baltimore City Precinct 12-002,1529,85,23,777,2306,1.0,0.663052905464007,0.3369470945359931,2198,0.03686036426712923,0.00997398091934085,0.9531656548135299
1109,Baltimore City,2090,Baltimore City Precinct 12-001,1535,964,165,555,2090,1.0,0.7344497607655502,0.26555023923444976,961,0.46124401913875596,0.07894736842105263,0.4598086124401914
1163,Baltimore City,2988,Baltimore City Precinct 28-006,115,674,25,2873,2988,1.0,0.03848728246318608,0.9615127175368139,2289,0.22556894243641232,0.008366800535475234,0.7660642570281124
1164,Baltimore City,1374,Baltimore City Precinct 28-007,38,385,10,1336,1374,1.0,0.027656477438136828,0.9723435225618632,979,0.2802037845705968,0.00727802037845706,0.7125181950509462
1165,Baltimore City,1808,Baltimore City Precinct 28-005,29,472,9,1779,1808,1.0,0.016039823008849558,0.9839601769911505,1327,0.2610619469026549,0.00497787610619469,0.7339601769911505
1166,Baltimore City,2470,Baltimore City Precinct 28-002,50,552,13,2420,2470,1.0,0.020242914979757085,0.979757085020243,1905,0.22348178137651822,0.005263157894736842,0.771255060728745
1167,Baltimore City,882,Baltimore City Precinct 28-004,11,219,16,871,882,1.0,0.012471655328798186,0.9875283446712018,647,0.24829931972789115,0.018140589569160998,0.7335600907029478
1168,Baltimore City,1074,Baltimore City Precinct 15-002,22,261,5,1052,1074,1.0,0.020484171322160148,0.9795158286778398,808,0.2430167597765363,0.004655493482309125,0.7523277467411545
1169,Baltimore City,2856,Baltimore City Precinct 15-009,38,825,23,2818,2856,1.0,0.01330532212885154,0.9866946778711485,2008,0.28886554621848737,0.008053221288515405,0.7030812324929971
1201,Baltimore City,1822,Baltimore City Precinct 03-001,235,503,17,1587,1822,1.0,0.12897914379802414,0.8710208562019759,1302,0.27607025246981337,0.009330406147091108,0.7145993413830956
1202,Baltimore City,356,Baltimore City Precinct 05-002,41,44,1,315,356,1.0,0.1151685393258427,0.8848314606741573,311,0.12359550561797752,0.0028089887640449437,0.8735955056179775
1203,Baltimore City,1273,Baltimore City Precinct 10-002,8,496,6,1265,1273,1.0,0.006284367635506678,0.9937156323644933,771,0.389630793401414,0.004713275726630008,0.605655930871956
1204,Baltimore City,987,Baltimore City Precinct 10-001,13,414,2,974,987,1.0,0.013171225937183385,0.9868287740628167,571,0.4194528875379939,0.002026342451874367,0.5785207700101317
1205,Baltimore City,1789,Baltimore City Precinct 09-015,22,613,14,1767,1789,1.0,0.012297372833985467,0.9877026271660145,1162,0.3426495248742314,0.007825600894354388,0.6495248742314143
1206,Baltimore City,1316,Baltimore City Precinct 12-007,363,563,15,953,1316,1.0,0.27583586626139817,0.7241641337386018,738,0.4278115501519757,0.011398176291793313,0.560790273556231
1207,Baltimore City,1357,Baltimore City Precinct 09-014,18,573,12,1339,1357,1.0,0.013264554163596167,0.9867354458364038,772,0.42225497420781133,0.008843036109064112,0.5689019896831246
1208,Baltimore City,364,Baltimore City Precinct 09-011,6,82,2,358,364,1.0,0.016483516483516484,0.9835164835164835,280,0.22527472527472528,0.005494505494505495,0.7692307692307693
1209,Baltimore City,917,Baltimore City Precinct 09-013,12,184,6,905,917,1.0,0.013086150490730643,0.9869138495092693,727,0.20065430752453653,0.006543075245365322,0.7928026172300982
1210,Baltimore City,1609,Baltimore City Precinct 09-012,36,481,10,1573,1609,1.0,0.022374145431945307,0.9776258545680547,1118,0.29894344313238036,0.006215040397762586,0.694841516469857
1211,Baltimore City,1368,Baltimore City Precinct 02-001,706,326,57,662,1368,1.0,0.5160818713450293,0.48391812865497075,985,0.23830409356725146,0.041666666666666664,0.7200292397660819
1212,Baltimore City,1117,Baltimore City Precinct 06-004,528,393,42,589,1117,1.0,0.4726947179946285,0.5273052820053715,682,0.35183527305282003,0.03760071620411817,0.6105640107430618
1213,Baltimore City,475,Baltimore City Precinct 06-003,44,175,5,431,475,1.0,0.09263157894736843,0.9073684210526316,295,0.3684210526315789,0.010526315789473684,0.6210526315789474
1214,Baltimore City,1050,Baltimore City Precinct 07-001,14,349,5,1036,1050,1.0,0.013333333333333334,0.9866666666666667,696,0.3323809523809524,0.004761904761904762,0.6628571428571428
1215,Baltimore City,583,Baltimore City Precinct 08-007,15,575,7,568,583,1.3197278911564625,0.025728987993138937,0.9742710120068611,1,0.9862778730703259,0.012006861063464836,0.0017152658662092624
1216,Baltimore City,250,Baltimore City Precinct 07-002,11,80,0,239,250,1.0,0.044,0.956,170,0.32,0.0,0.68
1217,Baltimore City,819,Baltimore City Precinct 06-002,107,227,10,712,819,1.0,0.13064713064713065,0.8693528693528694,582,0.2771672771672772,0.01221001221001221,0.7106227106227107
1218,Baltimore City,2445,Baltimore City Precinct 07-003,84,668,11,2361,2445,1.0,0.0343558282208589,0.9656441717791411,1766,0.27321063394683026,0.004498977505112475,0.7222903885480573
1219,Baltimore City,986,Baltimore City Precinct 08-008,30,358,77,956,986,1.0,0.030425963488843813,0.9695740365111561,551,0.3630831643002028,0.07809330628803246,0.5588235294117647
1220,Baltimore City,1928,Baltimore City Precinct 08-006,31,769,14,1897,1928,1.0,0.016078838174273857,0.9839211618257261,1145,0.39885892116182575,0.007261410788381743,0.5938796680497925
1221,Baltimore City,1774,Baltimore City Precinct 08-005,22,511,10,1752,1774,1.0,0.012401352874859075,0.9875986471251409,1253,0.28804960541149943,0.005636978579481398,0.7063134160090192
1222,Baltimore City,1071,Baltimore City Precinct 08-009,21,26,2,1050,1071,1.0,0.0196078431372549,0.9803921568627451,1043,0.02427637721755369,0.0018674136321195146,0.9738562091503268
1223,Baltimore City,473,Baltimore City Precinct 08-004,8,143,3,465,473,1.0,0.016913319238900635,0.9830866807610994,327,0.3023255813953488,0.006342494714587738,0.6913319238900634
1224,Baltimore City,951,Baltimore City Precinct 26-008,818,356,196,133,951,1.0,0.8601472134595163,0.1398527865404837,399,0.3743427970557308,0.20609884332281808,0.4195583596214511
1225,Baltimore City,2859,Baltimore City Precinct 01-004,2482,536,341,377,2859,1.0,0.8681357117873383,0.13186428821266177,1982,0.1874781392095138,0.1192724728926198,0.6932493878978664
1226,Baltimore City,3180,Baltimore City Precinct 01-005,2843,741,430,337,3180,1.0,0.8940251572327044,0.1059748427672956,2009,0.2330188679245283,0.13522012578616352,0.6317610062893082
1227,Baltimore City,3113,Baltimore City Precinct 26-009,2667,553,353,446,3113,1.0,0.856729842595567,0.14327015740443302,2207,0.1776421458400257,0.1133954384837777,0.7089624156761966
1228,Baltimore City,1478,Baltimore City Precinct 26-006,963,204,157,515,1478,1.0,0.6515561569688768,0.34844384303112313,1117,0.13802435723951287,0.10622462787550745,0.7557510148849798
1229,Baltimore City,1558,Baltimore City Precinct 01-001,1017,394,114,541,1558,1.0,0.6527599486521181,0.3472400513478819,1050,0.25288831835686776,0.07317073170731707,0.6739409499358151
1230,Baltimore City,3120,Baltimore City Precinct 06-005,1381,705,112,1739,3120,1.0,0.4426282051282051,0.5573717948717949,2303,0.22596153846153846,0.035897435897435895,0.7381410256410257
1231,Baltimore City,1744,Baltimore City Precinct 06-001,198,398,21,1546,1744,1.0,0.11353211009174312,0.8864678899082569,1325,0.22821100917431192,0.012041284403669725,0.7597477064220184
1232,Baltimore City,1555,Baltimore City Precinct 23-001,1384,429,175,171,1555,1.0,0.890032154340836,0.10996784565916398,951,0.27588424437299036,0.11254019292604502,0.6115755627009646
1233,Baltimore City,1449,Baltimore City Precinct 22-002,1253,535,159,196,1449,1.0,0.8647342995169082,0.13526570048309178,755,0.3692201518288475,0.10973084886128365,0.5210489993098689
1234,Baltimore City,1095,Baltimore City Precinct 22-001,797,279,103,298,1095,1.0,0.7278538812785388,0.27214611872146116,713,0.2547945205479452,0.09406392694063927,0.6511415525114155
1235,Baltimore City,1382,Baltimore City Precinct 19-001,24,475,7,1358,1382,1.0,0.017366136034732273,0.9826338639652678,900,0.34370477568740954,0.005065123010130246,0.6512301013024602
1236,Baltimore City,1137,Baltimore City Precinct 16-003,9,268,7,1128,1137,1.0,0.0079155672823219,0.9920844327176781,862,0.2357080035180299,0.006156552330694811,0.7581354441512753
1237,Baltimore City,1737,Baltimore City Precinct 16-002,27,384,11,1710,1737,1.0,0.015544041450777202,0.9844559585492227,1342,0.22107081174438686,0.0063327576280944155,0.7725964306275187
1238,Baltimore City,985,Baltimore City Precinct 16-001,18,277,0,967,985,1.0,0.018274111675126905,0.9817258883248731,708,0.2812182741116751,0.0,0.7187817258883249
1239,Baltimore City,1226,Baltimore City Precinct 18-001,14,296,4,1212,1226,1.0,0.011419249592169658,0.9885807504078303,926,0.24143556280587275,0.0032626427406199023,0.7553017944535073
1240,Baltimore City,1367,Baltimore City Precinct 17-002,16,828,20,1351,1367,1.0,0.011704462326261888,0.9882955376737381,519,0.6057059253840527,0.014630577907827359,0.37966349670812
1241,Baltimore City,1008,Baltimore City Precinct 14-003,24,288,8,984,1008,1.0,0.023809523809523808,0.9761904761904762,712,0.2857142857142857,0.007936507936507936,0.7063492063492064
1242,Baltimore City,1794,Baltimore City Precinct 15-019,31,36,0,1763,1794,1.0,0.017279821627647716,0.9827201783723523,1758,0.020066889632107024,0.0,0.979933110367893
1243,Baltimore City,529,Baltimore City Precinct 14-005,4,167,2,525,529,1.0,0.007561436672967864,0.9924385633270322,360,0.31568998109640833,0.003780718336483932,0.6805293005671077
1244,Baltimore City,1897,Baltimore City Precinct 13-008,110,608,14,1787,1897,1.0,0.05798629414865577,0.9420137058513443,1275,0.32050606220347916,0.007380073800738007,0.6721138639957828
1245,Baltimore City,1483,Baltimore City Precinct 13-007,15,501,5,1468,1483,1.0,0.010114632501685773,0.9898853674983142,977,0.3378287255563048,0.0033715441672285905,0.6587997302764667
1246,Baltimore City,2314,Baltimore City Precinct 14-004,223,803,21,2091,2314,1.0,0.09636992221261884,0.9036300777873811,1490,0.3470181503889369,0.009075194468452896,0.6439066551426103
1247,Baltimore City,1277,Baltimore City Precinct 13-009,88,363,9,1189,1277,1.0,0.06891151135473766,0.9310884886452623,905,0.28425998433829286,0.007047768206734534,0.7086922474549726
1248,Baltimore City,1887,Baltimore City Precinct 13-010,272,485,18,1615,1887,1.0,0.14414414414414414,0.8558558558558559,1384,0.2570217276099629,0.009538950715421303,0.7334393216746158
1249,Baltimore City,588,Baltimore City Precinct 04-003,33,194,4,555,588,1.0,0.05612244897959184,0.9438775510204082,390,0.3299319727891156,0.006802721088435374,0.6632653061224489
1250,Baltimore City,2521,Baltimore City Precinct 04-002,1231,636,70,1290,2521,1.0,0.48829829432764776,0.5117017056723523,1815,0.25228084093613645,0.027766759222530742,0.7199523998413329
1251,Baltimore City,1979,Baltimore City Precinct 17-001,162,62,1,1817,1979,1.0,0.08185952501263265,0.9181404749873674,1916,0.031328954017180395,0.0005053057099545225,0.9681657402728651
1252,Baltimore City,1028,Baltimore City Precinct 11-004,115,32,0,913,1028,1.0,0.11186770428015565,0.8881322957198443,996,0.0311284046692607,0.0,0.9688715953307393
1253,Baltimore City,1704,Baltimore City Precinct 11-003,892,602,44,812,1704,1.0,0.5234741784037559,0.4765258215962441,1058,0.3532863849765258,0.025821596244131457,0.6208920187793427
1254,Baltimore City,2097,Baltimore City Precinct 04-001,924,216,46,1173,2097,1.0,0.4406294706723891,0.5593705293276109,1835,0.10300429184549356,0.021936099189318072,0.8750596089651884
1255,Baltimore City,2967,Baltimore City Precinct 11-006,1600,809,73,1367,2967,1.0,0.5392652510953826,0.46073474890461746,2085,0.2726659925851028,0.02460397708122683,0.7027300303336703
1256,Baltimore City,870,Baltimore City Precinct 11-005,547,452,27,323,870,1.0,0.628735632183908,0.37126436781609196,391,0.5195402298850574,0.03103448275862069,0.4494252873563218
1257,Baltimore City,645,Baltimore City Precinct 11-002,302,172,18,343,645,1.0,0.4682170542635659,0.5317829457364341,455,0.26666666666666666,0.027906976744186046,0.7054263565891473
1258,Baltimore City,1818,Baltimore City Precinct 11-007,1109,571,51,709,1818,1.0,0.61001100110011,0.38998899889988997,1196,0.3140814081408141,0.028052805280528052,0.6578657865786579
1259,Baltimore City,1899,Baltimore City Precinct 11-001,1177,570,50,722,1899,1.0,0.6197998946814113,0.3802001053185887,1279,0.3001579778830964,0.02632964718272775,0.6735123749341759
1260,Baltimore City,1670,Baltimore City Precinct 14-002,830,301,11,840,1670,1.0,0.49700598802395207,0.5029940119760479,1358,0.18023952095808382,0.006586826347305389,0.8131736526946107
1261,Baltimore City,1524,Baltimore City Precinct 14-001,930,391,24,594,1524,1.0,0.610236220472441,0.38976377952755903,1109,0.25656167979002625,0.015748031496062992,0.7276902887139107
1262,Baltimore City,2304,Baltimore City Precinct 12-009,1078,543,101,1226,2304,1.0,0.4678819444444444,0.5321180555555556,1660,0.23567708333333334,0.04383680555555555,0.7204861111111112
1263,Baltimore City,1485,Baltimore City Precinct 12-012,447,541,20,1038,1485,1.0,0.301010101010101,0.6989898989898989,924,0.3643097643097643,0.013468013468013467,0.6222222222222222
1289,Baltimore City,1691,Baltimore City Precinct 16-009,6,557,4,1685,1691,1.0,0.0035481963335304554,0.9964518036664696,1130,0.32939089296274393,0.002365464222353637,0.6682436428149024
1290,Baltimore City,1025,Baltimore City Precinct 16-010,10,313,3,1015,1025,1.0,0.00975609756097561,0.9902439024390244,709,0.3053658536585366,0.002926829268292683,0.6917073170731707
1291,Baltimore City,936,Baltimore City Precinct 16-011,6,256,4,930,936,1.0,0.00641025641025641,0.9935897435897436,676,0.27350427350427353,0.004273504273504274,0.7222222222222222
1292,Baltimore City,365,Baltimore City Precinct 15-012,13,84,0,352,365,1.0,0.03561643835616438,0.9643835616438357,281,0.23013698630136986,0.0,0.7698630136986301
1293,Baltimore City,1645,Baltimore City Precinct 15-007,21,426,8,1624,1645,1.0,0.01276595744680851,0.9872340425531915,1211,0.2589665653495441,0.004863221884498481,0.7361702127659574
1294,Baltimore City,754,Baltimore City Precinct 15-013,5,234,3,749,754,1.0,0.006631299734748011,0.993368700265252,517,0.3103448275862069,0.003978779840848806,0.6856763925729443
1295,Baltimore City,813,Baltimore City Precinct 15-015,5,209,5,808,813,1.0,0.006150061500615006,0.993849938499385,599,0.2570725707257073,0.006150061500615006,0.7367773677736777
1296,Baltimore City,1295,Baltimore City Precinct 15-014,10,445,8,1285,1295,1.0,0.007722007722007722,0.9922779922779923,842,0.3436293436293436,0.006177606177606178,0.6501930501930502
1297,Baltimore City,1699,Baltimore City Precinct 15-006,17,574,13,1682,1699,1.0,0.010005885815185403,0.9899941141848146,1112,0.33784579164214246,0.007651559741024131,0.6545026486168334
1298,Baltimore City,964,Baltimore City Precinct 16-007,6,469,11,958,964,1.0,0.006224066390041493,0.9937759336099585,484,0.48651452282157676,0.011410788381742738,0.5020746887966805
1299,Baltimore City,1884,Baltimore City Precinct 16-006,7,536,5,1877,1884,1.0,0.0037154989384288748,0.9962845010615711,1343,0.28450106157112526,0.002653927813163482,0.7128450106157113
1300,Baltimore City,1791,Baltimore City Precinct 20-001,30,492,4,1761,1791,1.0,0.01675041876046901,0.983249581239531,1295,0.2747068676716918,0.002233389168062535,0.7230597431602457
1301,Baltimore City,764,Baltimore City Precinct 16-004,12,161,4,752,764,1.0,0.015706806282722512,0.9842931937172775,599,0.2107329842931937,0.005235602094240838,0.7840314136125655
1302,Baltimore City,2126,Baltimore City Precinct 16-005,27,545,6,2099,2126,1.0,0.012699905926622766,0.9873000940733773,1575,0.25634995296331137,0.0028222013170272815,0.7408278457196613
1303,Baltimore City,1404,Baltimore City Precinct 15-018,4,983,12,1400,1404,1.0,0.002849002849002849,0.9971509971509972,409,0.7001424501424501,0.008547008547008548,0.2913105413105413
1304,Baltimore City,1040,Baltimore City Precinct 15-016,9,265,4,1031,1040,1.0,0.008653846153846154,0.9913461538461539,771,0.2548076923076923,0.0038461538461538464,0.7413461538461539
1305,Baltimore City,2987,Baltimore City Precinct 15-020,37,757,6,2950,2987,1.0,0.012387010378305993,0.987612989621694,2224,0.25343153665885504,0.002008704385671242,0.7445597589554738
1306,Baltimore City,1237,Baltimore City Precinct 15-021,14,291,4,1223,1237,1.0,0.01131770412287793,0.9886822958771221,942,0.23524656426839127,0.0032336297493936943,0.761519805982215
1307,Baltimore City,1807,Baltimore City Precinct 15-017,23,666,9,1784,1807,1.0,0.012728278915329275,0.9872717210846708,1132,0.3685666851134477,0.004980630879911455,0.6264526840066409
1308,Baltimore City,1062,Baltimore City Precinct 25-006,24,386,4,1038,1062,1.0,0.022598870056497175,0.9774011299435028,672,0.3634651600753296,0.003766478342749529,0.632768361581921
1309,Baltimore City,596,Baltimore City Precinct 25-007,133,180,14,463,596,1.0,0.2231543624161074,0.7768456375838926,402,0.30201342281879195,0.02348993288590604,0.674496644295302
1310,Baltimore City,2234,Baltimore City Precinct 21-003,992,555,107,1242,2234,1.0,0.4440465532676813,0.5559534467323187,1572,0.2484333034914951,0.047896150402864816,0.7036705461056401
1311,Baltimore City,3343,Baltimore City Precinct 19-002,1090,505,67,2253,3343,1.0,0.3260544421178582,0.6739455578821418,2771,0.1510619204307508,0.020041878552198623,0.8288962010170505
1312,Baltimore City,489,Baltimore City Precinct 21-004,246,154,30,243,489,1.0,0.5030674846625767,0.49693251533742333,305,0.3149284253578732,0.06134969325153374,0.623721881390593
1313,Baltimore City,1952,Baltimore City Precinct 18-002,558,428,37,1394,1952,1.0,0.2858606557377049,0.7141393442622951,1487,0.2192622950819672,0.018954918032786885,0.7617827868852459
1314,Baltimore City,1673,Baltimore City Precinct 21-002,672,499,66,1001,1673,1.0,0.401673640167364,0.5983263598326359,1108,0.29826658696951586,0.03945008965929468,0.6622833233711894
1315,Baltimore City,2033,Baltimore City Precinct 23-003,1802,592,278,231,2033,1.0,0.8863748155435317,0.11362518445646827,1163,0.2911952779144122,0.1367437284800787,0.5720609936055091
1316,Baltimore City,1153,Baltimore City Precinct 21-001,755,242,28,398,1153,1.0,0.6548135299219427,0.34518647007805725,883,0.209887250650477,0.024284475281873375,0.7658282740676496
1317,Baltimore City,1038,Baltimore City Precinct 23-002,584,344,64,454,1038,1.0,0.5626204238921002,0.4373795761078998,630,0.33140655105973027,0.06165703275529865,0.6069364161849711
1318,Baltimore City,2506,Baltimore City Precinct 20-007,148,531,35,2358,2506,1.0,0.05905826017557861,0.9409417398244214,1940,0.21189146049481244,0.013966480446927373,0.7741420590582602
1319,Baltimore City,2106,Baltimore City Precinct 28-010,255,479,41,1851,2106,1.0,0.12108262108262108,0.8789173789173789,1586,0.22744539411206077,0.0194681861348528,0.7530864197530864
1320,Baltimore City,458,Baltimore City Precinct 28-012,55,282,40,403,458,1.0,0.12008733624454149,0.8799126637554585,136,0.6157205240174672,0.08733624454148471,0.29694323144104806
1321,Baltimore City,2423,Baltimore City Precinct 28-009,274,660,30,2149,2423,1.0,0.1130829550144449,0.8869170449855551,1733,0.2723895996698308,0.012381345439537762,0.7152290548906315
1322,Baltimore City,1962,Baltimore City Precinct 28-011,173,463,36,1789,1962,1.0,0.08817533129459736,0.9118246687054027,1463,0.23598369011213047,0.01834862385321101,0.7456676860346585
1323,Baltimore City,3079,Baltimore City Precinct 20-006,15,846,5,3064,3079,1.0,0.004871711594673595,0.9951282884053264,2228,0.27476453393959077,0.0016239038648911985,0.723611562195518
1324,Baltimore City,3001,Baltimore City Precinct 16-014,29,628,9,2972,3001,1.0,0.009663445518160613,0.9903365544818394,2364,0.2092635788070643,0.002999000333222259,0.7877374208597134
1325,Baltimore City,1740,Baltimore City Precinct 28-008,83,400,6,1657,1740,1.0,0.04770114942528736,0.9522988505747126,1334,0.22988505747126436,0.0034482758620689655,0.7666666666666667
1326,Baltimore City,1451,Baltimore City Precinct 15-011,43,446,12,1408,1451,1.0,0.029634734665747762,0.9703652653342523,993,0.3073742246726396,0.008270158511371467,0.684355616815989
1327,Baltimore City,1492,Baltimore City Precinct 15-010,39,401,13,1453,1492,1.0,0.02613941018766756,0.9738605898123325,1078,0.2687667560321716,0.00871313672922252,0.7225201072386059
1375,Baltimore City,2932,Baltimore City Precinct 28-015,976,528,78,1956,2932,1.0,0.3328785811732606,0.6671214188267395,2326,0.1800818553888131,0.02660300136425648,0.7933151432469304
1376,Baltimore City,2794,Baltimore City Precinct 25-001,329,838,51,2465,2794,1.0,0.11775232641374374,0.8822476735862562,1905,0.2999284180386543,0.01825340014316392,0.6818181818181818
1377,Baltimore City,742,Baltimore City Precinct 28-014,55,195,9,687,742,1.0,0.07412398921832884,0.9258760107816711,538,0.2628032345013477,0.012129380053908356,0.7250673854447439
1378,Baltimore City,2138,Baltimore City Precinct 25-002,205,578,32,1933,2138,1.0,0.09588400374181479,0.9041159962581852,1528,0.27034611786716556,0.014967259120673527,0.7146866230121609
1379,Baltimore City,1494,Baltimore City Precinct 28-013,105,328,13,1389,1494,1.0,0.07028112449799197,0.929718875502008,1153,0.21954484605087016,0.008701472556894244,0.7717536813922357
1380,Baltimore City,714,Baltimore City Precinct 20-008,104,161,11,610,714,1.0,0.14565826330532214,0.8543417366946778,542,0.22549019607843138,0.015406162464985995,0.7591036414565826
1698,Baltimore City,1766,Baltimore City Precinct 15-001,42,451,9,1724,1766,1.0,0.02378255945639864,0.9762174405436014,1306,0.25537938844847113,0.005096262740656852,0.739524348810872
1699,Baltimore City,571,Baltimore City Precinct 28-003,5,131,3,566,571,1.0,0.008756567425569177,0.9912434325744308,437,0.22942206654991243,0.005253940455341506,0.7653239929947461
1700,Baltimore City,1228,Baltimore City Precinct 27-061,324,169,32,904,1228,1.0,0.26384364820846906,0.7361563517915309,1027,0.13762214983713356,0.026058631921824105,0.8363192182410424
1701,Baltimore City,1238,Baltimore City Precinct 27-056,13,301,6,1225,1238,1.0,0.01050080775444265,0.9894991922455574,931,0.2431340872374798,0.004846526655896607,0.7520193861066236
1702,Baltimore City,2460,Baltimore City Precinct 27-057,36,453,2,2424,2460,1.0,0.014634146341463415,0.9853658536585366,2005,0.18414634146341463,0.0008130081300813008,0.8150406504065041
1703,Baltimore City,1163,Baltimore City Precinct 27-059,32,203,5,1131,1163,1.0,0.027515047291487533,0.9724849527085124,955,0.17454858125537404,0.004299226139294927,0.821152192605331
1704,Baltimore City,1669,Baltimore City Precinct 28-001,105,382,13,1564,1669,1.0,0.06291192330736968,0.9370880766926303,1274,0.22887956860395448,0.007789095266626723,0.7633313361294188
1705,Baltimore City,3062,Baltimore City Precinct 27-067,1028,476,199,2034,3062,1.0,0.3357282821685173,0.6642717178314826,2387,0.15545395166557804,0.06499020248203788,0.779555845852384
1706,Baltimore City,2688,Baltimore City Precinct 27-062,1151,270,227,1537,2688,1.0,0.42819940476190477,0.5718005952380952,2191,0.10044642857142858,0.08444940476190477,0.8151041666666666
1707,Baltimore City,2392,Baltimore City Precinct 27-066,1756,216,414,636,2392,1.0,0.7341137123745819,0.26588628762541805,1762,0.0903010033444816,0.17307692307692307,0.7366220735785953
1709,Baltimore City,1675,Baltimore City Precinct 27-063,770,305,211,905,1675,1.0,0.4597014925373134,0.5402985074626866,1159,0.18208955223880596,0.12597014925373134,0.6919402985074626
1710,Baltimore City,3698,Baltimore City Precinct 27-065,2866,405,455,832,3698,1.0,0.775013520822066,0.22498647917793402,2838,0.10951865873445106,0.12303948080043267,0.7674418604651163
1711,Baltimore City,997,Baltimore City Precinct 27-060,171,308,87,826,997,1.0,0.1715145436308927,0.8284854563691073,602,0.30892678034102306,0.08726178535606821,0.6038114343029087
1712,Baltimore City,1689,Baltimore City Precinct 27-064,1206,239,305,483,1689,1.0,0.7140319715808171,0.28596802841918295,1145,0.1415038484310243,0.18058022498519835,0.6779159265837774
1726,Baltimore City,818,Baltimore City Precinct 15-008,13,219,8,805,818,1.0,0.01589242053789731,0.9841075794621027,591,0.26772616136919314,0.009779951100244499,0.7224938875305623
1727,Baltimore City,2394,Baltimore City Precinct 15-003,33,733,14,2361,2394,1.0,0.013784461152882205,0.9862155388471178,1647,0.30618212197159567,0.005847953216374269,0.6879699248120301
1728,Baltimore City,1024,Baltimore City Precinct 15-004,8,283,6,1016,1024,1.0,0.0078125,0.9921875,735,0.2763671875,0.005859375,0.7177734375
1729,Baltimore City,1372,Baltimore City Precinct 15-005,11,409,17,1361,1372,1.0,0.008017492711370262,0.9919825072886297,946,0.2981049562682216,0.01239067055393586,0.6895043731778425
